Station,Latitude,Longitude,Cluster,CurrentInventory,OptimalInventory,InventoryDiff,BCRF
5,40.7482,-73.8794,1,3,16,-13,0.000571718
8,40.7028,-73.9333,1,16,8,8,0.000574625
11,40.7584,-73.8953,1,18,10,8,0.000944417
13,40.7256,-73.9443,1,46,38,8,0.000863125
14,40.7625,-73.9025,1,3,6,-3,0.000882778
18,40.7069,-73.9285,1,16,9,7,0.000595143
32,40.6906,-73.9575,1,10,5,5,0.000500333
38,40.6886,-73.9123,1,10,11,-1,0.0002645
43,40.7183,-73.9013,1,17,17,0,0
46,40.7368,-73.8732,1,19,17,2,0.000295083
47,40.7552,-73.9486,1,20,2,18,0.00103228
49,40.7533,-73.9434,1,1,6,-5,0.00198367
51,40.653,-73.946,1,6,2,4,0.000611917
53,40.7188,-73.9395,1,10,4,6,0.000443611
57,40.7011,-73.9142,1,9,17,-8,0.000979
68,40.7443,-73.926,1,5,20,-15,0.000728578
69,40.753,-73.8727,1,0,20,-20,0.000873367
78,40.7132,-73.9389,1,16,11,5,0.001439
81,40.7462,-73.8719,1,2,19,-17,0.000741598
87,40.7343,-73.9837,1,10,4,6,0.000549444
88,40.7446,-73.8739,1,1,17,-16,0.00109282
94,40.693,-73.9082,1,5,15,-10,0.000896533
97,40.7461,-73.8527,1,25,19,6,0.000284306
104,40.7473,-73.912,1,6,10,-4,0.000171667
106,40.7424,-73.9181,1,4,14,-10,0.00066165
114,40.6742,-73.9166,1,13,17,-4,0.000576833
117,40.6792,-73.9259,1,14,10,4,0.000310583
118,40.7436,-73.8862,1,6,4,2,0.000424333
120,40.7468,-73.9089,1,10,17,-7,0.000913643
122,40.78,-73.9067,1,9,1,8,0.00105388
124,40.6968,-73.9376,1,16,13,3,0.000267778
128,40.7645,-73.9046,1,14,8,6,0.000423806
134,40.6582,-73.9338,1,16,14,2,0.0001735
137,40.7524,-73.8672,1,6,19,-13,0.000815833
138,40.701,-73.9392,1,29,19,10,0.0023545
141,40.6787,-73.9111,1,15,13,2,0.00021425
143,40.6978,-73.9262,1,16,19,-3,0.000462222
144,40.7526,-73.9728,1,4,3,1,0.000281667
148,40.7518,-73.8857,1,4,21,-17,0.000813333
150,40.7749,-73.9342,1,16,15,1,0.000122833
154,40.7576,-73.8868,1,10,14,-4,0.000197625
155,40.7126,-73.9606,1,21,16,5,0.000321333
158,40.6968,-73.923,1,18,21,-3,0.000663333
163,40.7554,-73.9115,1,7,1,6,0.000525444
164,40.7298,-73.9484,1,38,3,35,0.00110738
165,40.702,-73.8929,1,11,16,-5,0.000677833
166,40.7471,-73.9028,1,9,7,2,0.000659167
171,40.7392,-73.8526,1,13,15,-2,0.0001175
174,40.7419,-73.9091,1,1,12,-11,0.000892136
181,40.753,-73.8924,1,16,18,-2,0.000315417
185,40.7579,-73.8576,1,1,3,-2,0.000652667
187,40.698,-73.9127,1,2,4,-2,0.000471333
190,40.7134,-73.9491,1,10,10,0,0
191,40.6797,-73.9347,1,8,6,2,0.000188167
194,40.7435,-73.9186,1,7,12,-5,0.000447
198,40.7392,-73.8689,1,18,18,0,0
200,40.7426,-73.903,1,5,14,-9,0.000950833
202,40.754,-73.8689,1,2,20,-18,0.00113359
209,40.748,-73.9467,1,16,8,8,0.000708333
212,40.7516,-73.8591,1,7,9,-2,0.000138167
214,40.7472,-73.9433,1,11,13,-2,0.000204167
217,40.7409,-73.8677,1,13,15,-2,0.000178917
218,40.6857,-73.9156,1,11,3,8,0.00125452
221,40.6527,-73.9499,1,22,13,9,0.00129857
222,40.7092,-73.9606,1,12,4,8,0.000717083
223,40.7631,-73.8772,1,15,14,1,3.2e-05
228,40.6792,-73.9219,1,10,8,2,0.000174
233,40.7097,-73.9079,1,4,8,-4,0.000549583
237,40.7418,-73.8956,1,12,14,-2,0.000499833
243,40.7251,-73.9752,1,26,20,6,0.00155611
244,40.7441,-73.929,1,1,2,-1,0.00096
245,40.6613,-73.9609,1,12,4,8,0.00100729
247,40.6891,-73.9051,1,24,9,15,0.000777111
250,40.7041,-73.9074,1,6,14,-8,0.000621667
261,40.7537,-73.886,1,7,17,-10,0.000348833
264,40.7192,-73.9489,1,35,5,30,0.000445889
266,40.7411,-73.9425,1,3,1,2,0.000233333
267,40.7541,-73.9195,1,18,19,-1,0.0001985
273,40.7237,-73.9046,1,12,6,6,0.000662167
282,40.7123,-73.894,1,10,23,-13,0.00090059
283,40.6762,-73.9035,1,0,6,-6,0.000906667
287,40.6507,-73.9499,1,24,10,14,0.00107556
288,40.77,-73.982,1,17,7,10,0.0009775
290,40.7524,-73.9254,1,4,17,-13,0.000544167
299,40.7261,-73.9092,1,11,8,3,0.000259778
305,40.7378,-73.9302,1,7,7,0,0
309,40.7456,-73.924,1,0,16,-16,0.00123292
310,40.7338,-73.9805,1,45,41,4,0.0002725
317,40.7683,-73.8733,1,17,2,15,0.000849778
320,40.6732,-73.9108,1,12,14,-2,7.01667e-05
323,40.754,-73.8575,1,18,14,4,0.000172042
324,40.7125,-73.9187,1,16,14,2,0.00022375
327,40.7,-73.9283,1,22,15,7,0.00357095
328,40.7654,-73.8826,1,19,1,18,0.000827
329,40.6972,-73.8981,1,10,19,-9,0.00124663
331,40.6931,-73.9431,1,13,11,2,0.0002175
332,40.7356,-73.9528,1,38,24,14,0.00183714
335,40.754,-73.862,1,17,15,2,0.000668083
336,40.7179,-73.9085,1,20,21,-1,0.0468045
337,40.7659,-73.8779,1,12,7,5,0.000229467
338,40.7366,-73.9929,1,10,8,2,7.75e-05
340,40.6975,-73.9359,1,12,9,3,0.000485556
341,40.6952,-73.9031,1,0,6,-6,0.00312028
344,40.6767,-73.9305,1,6,8,-2,0.000195
355,40.744,-73.8678,1,8,10,-2,6.63333e-05
359,40.7465,-73.88,1,1,17,-16,0.000979094
362,40.7754,-73.948,1,30,26,4,0.000484583
363,40.7547,-73.9337,1,7,10,-3,0.000390889
367,40.7552,-73.8467,1,10,5,5,0.000267
372,40.7433,-73.899,1,2,16,-14,0.000828786
376,40.6997,-73.9022,1,11,19,-8,0.000847292
377,40.6795,-73.9047,1,20,16,4,0.000182917
379,40.7011,-73.9304,1,12,13,-1,0.00044
381,40.6883,-73.9331,1,12,15,-3,0.000423889
387,40.7352,-73.9549,1,31,28,3,0.000675
389,40.7595,-73.8843,1,14,17,-3,0.000353889
393,40.6756,-73.9415,1,7,6,1,3e-05
394,40.764,-73.8669,1,13,14,-1,0.000182333
395,40.7536,-73.938,1,1,11,-10,0.000755017
396,40.7017,-73.9275,1,19,19,0,0
400,40.7581,-73.9243,1,13,17,-4,0.000258583
403,40.7508,-73.9783,1,10,7,3,0.00015
410,40.7005,-73.8943,1,6,13,-7,0.000837833
414,40.6992,-73.8979,1,1,16,-15,0.000895278
416,40.7508,-73.8751,1,2,9,-7,0.0005195
417,40.7452,-73.9473,1,14,3,11,0.000636667
418,40.6849,-73.9293,1,11,12,-1,0.000285
419,40.7028,-73.9532,1,17,1,16,0.00063151
421,40.7049,-73.9199,1,21,13,8,0.000533021
424,40.6803,-73.9558,1,15,4,11,0.00104515
426,40.6622,-73.9429,1,20,12,8,0.00174438
427,40.741,-73.986,1,7,5,2,0.000899167
432,40.6986,-73.9413,1,7,1,6,0.000821389
433,40.7665,-73.8867,1,17,1,16,0.00100282
439,40.7581,-73.9098,1,7,17,-10,0.0012775
444,40.7373,-73.9924,1,26,22,4,0.000142083
445,40.7557,-73.9237,1,21,13,8,0.000855208
451,40.6815,-73.9142,1,4,13,-9,0.000733648
453,40.7312,-73.9516,1,19,15,4,0.00139017
454,40.6699,-73.92,1,10,14,-4,0.000230417
456,40.7658,-73.9265,1,11,11,0,0
462,40.6555,-73.9497,1,16,12,4,0.000200792
467,40.7771,-73.9024,1,20,1,19,0.00108882
473,40.7431,-73.8572,1,16,18,-2,0.000607333
474,40.7192,-73.9124,1,3,1,2,0.0006575
476,40.7354,-73.988,1,34,26,8,0.000294375
477,40.693,-73.9487,1,18,13,5,0.00259533
478,40.7051,-73.9441,1,20,18,2,0.0008925
479,40.703,-73.93,1,17,15,2,0.00114883
490,40.7135,-73.946,1,21,21,0,0
494,40.7571,-73.8722,1,3,19,-16,0.000730615
498,40.7484,-73.907,1,3,17,-14,0.000883464
503,40.7162,-73.9826,1,30,28,2,0.000478333
508,40.7591,-73.9592,1,14,8,6,0.000479167
510,40.7102,-73.9373,1,22,9,13,0.000892179
519,40.7489,-73.909,1,5,17,-12,0.00106349
520,40.6913,-73.9452,1,16,13,3,0.001175
521,40.7089,-73.9018,1,1,18,-17,0.000795392
522,40.7189,-73.9143,1,5,2,3,0.000527167
525,40.7035,-73.9178,1,9,12,-3,0.0005
526,40.7779,-73.946,1,19,11,8,0.000683125
529,40.7399,-73.924,1,5,12,-7,0.000496905
540,40.755,-73.889,1,9,30,-21,0.000529524
542,40.7383,-73.8791,1,24,22,2,-0.00888458
546,40.7542,-73.9089,1,14,13,1,1.38333e-05
547,40.6804,-73.9284,1,5,4,1,0.000428333
549,40.6938,-73.9097,1,4,10,-6,0.000271944
553,40.6934,-73.9006,1,11,12,-1,0.000311667
554,40.733,-73.871,1,25,20,5,0.000522367
556,40.6501,-73.96,1,21,19,2,0.000325417
558,40.7492,-73.8705,1,0,3,-3,0.00219772
563,40.7754,-73.9001,1,15,10,5,0.0005757
565,40.7216,-73.903,1,4,12,-8,0.000488646
566,40.7579,-73.884,1,8,16,-8,0.000632771
567,40.7347,-73.865,1,19,3,16,0.000861604
572,40.6986,-73.9189,1,28,4,24,0.000802368
573,40.729,-73.9012,1,11,16,-5,0.000305367
574,40.7153,-73.9387,1,22,19,3,0.000793333
575,40.6967,-73.9281,1,15,18,-3,0.000528667
577,40.7428,-73.9321,1,10,3,7,0.000527095
579,40.6449,-73.9549,1,23,20,3,0.0016115
583,40.7548,-73.8549,1,26,19,7,0.000307786
591,40.7652,-73.8648,1,16,6,10,0.000631217
593,40.7634,-73.9141,1,4,4,0,0
594,40.6996,-73.9471,1,4,3,1,0.00049
595,40.7055,-73.9096,1,3,10,-7,0.00079119
596,40.6632,-73.9508,1,10,7,3,0.000235
600,40.6794,-73.9299,1,5,5,0,0
603,40.7423,-73.9541,1,6,6,0,0
604,40.7357,-73.9348,1,14,6,8,0.000623521
608,40.6518,-73.9313,1,19,1,18,0.00103021
609,40.7151,-73.9445,1,11,6,5,0.000681667
614,40.7133,-73.9157,1,16,4,12,0.00101437
617,40.7621,-73.9252,1,4,4,0,0
620,40.7007,-73.9074,1,3,5,-2,0.000595083
621,40.6428,-73.9792,1,10,6,4,0.000243917
624,40.6693,-73.9368,1,11,7,4,0.000261792
625,40.7511,-73.9407,1,0,21,-21,0.00142921
627,40.7431,-73.8547,1,13,31,-18,0.000648907
628,40.6954,-73.9196,1,5,10,-5,0.000316333
633,40.7702,-73.8759,1,15,3,12,0.00164401
635,40.6904,-73.9277,1,7,13,-6,0.0005675
636,40.7388,-73.9034,1,16,11,5,0.000523067
642,40.7602,-73.9849,1,22,14,8,0.000702083
655,40.7524,-73.9297,1,3,10,-7,0.000538786
662,40.7531,-73.9206,1,23,7,16,0.000560167
669,40.7031,-73.8955,1,2,23,-21,0.00119637
670,40.6981,-73.909,1,2,19,-17,0.000912451
680,40.705,-73.8996,1,1,13,-12,0.00111914
685,40.7298,-73.9591,1,33,28,5,0.00192967
687,40.7442,-73.8619,1,17,18,-1,0.000141333
688,40.7642,-73.9158,1,2,4,-2,0.00106
689,40.6802,-73.9114,1,6,7,-1,7.33333e-05
691,40.6774,-73.9083,1,9,8,1,0.0001655
692,40.6837,-73.9261,1,10,14,-4,0.000741667
695,40.7602,-73.9363,1,11,8,3,0.000427222
697,40.7494,-73.8974,1,7,3,4,0.00057075
705,40.7409,-73.9171,1,1,14,-13,0.000769936
707,40.6785,-73.9164,1,2,13,-11,0.000643939
709,40.7542,-73.9003,1,19,10,9,0.000342056
710,40.7119,-73.944,1,19,16,3,0.000358333
713,40.7462,-73.9162,1,7,19,-12,0.000815139
714,40.7469,-73.8965,1,4,4,0,0
715,40.7235,-73.8997,1,13,17,-4,0.000406167
717,40.7381,-73.9549,1,26,27,-1,0.000285
719,40.7323,-73.9551,1,44,44,0,0
723,40.7445,-73.8811,1,6,21,-15,0.000875689
724,40.7191,-73.9422,1,18,16,2,0.000525
728,40.7027,-73.921,1,23,23,0,0
730,40.7742,-73.9127,1,9,6,3,0.000568333
731,40.7641,-73.9107,1,13,12,1,4e-05
736,40.7045,-73.9351,1,12,6,6,0.000559167
742,40.7167,-73.9364,1,25,2,23,-0.00288325
746,40.7567,-73.8959,1,14,15,-1,0.000351167
751,40.7387,-73.9409,1,10,3,7,0.000642857
754,40.654,-73.9297,1,18,11,7,0.000524452
755,40.7193,-73.945,1,21,24,-3,0.000816111
756,40.6579,-73.9474,1,18,12,6,0.00122656
757,40.7039,-73.8912,1,17,18,-1,0.000211833
760,40.7322,-73.9438,1,11,0,11,0.00103409
762,40.6866,-73.9168,1,1,21,-20,0.000926975
769,40.7445,-73.8652,1,5,4,1,9.23333e-05
780,40.7565,-73.9296,1,5,10,-5,0.000347
785,40.7271,-73.953,1,26,17,9,0.00266056
789,40.7058,-73.8968,1,5,7,-2,0.000336083
792,40.7007,-73.8991,1,4,24,-20,0.000915167
793,40.7634,-73.9286,1,12,11,1,3e-05
795,40.7144,-73.9141,1,16,10,6,0.000533472
797,40.752,-73.8999,1,21,20,1,0.000526667
802,40.7595,-73.8649,1,1,18,-17,0.00113838
804,40.7258,-73.9508,1,24,16,8,0.000652917
806,40.7379,-73.9226,1,10,10,0,0
813,40.6934,-73.9399,1,14,9,5,0.00157867
816,40.75,-73.8806,1,3,18,-15,0.000930978
817,40.7577,-73.9166,1,6,21,-15,0.000849467
821,40.6814,-73.9076,1,0,14,-14,0.00121733
824,40.7429,-73.8928,1,1,15,-14,0.000774893
825,40.757,-73.8924,1,17,17,0,0
827,40.7069,-73.9063,1,5,15,-10,0.000844167
832,40.7072,-73.9358,1,22,5,17,0.000995059
838,40.6757,-73.914,1,9,17,-8,0.00050775
841,40.7455,-73.9099,1,10,13,-3,0.000313056
844,40.7471,-73.9498,1,12,7,5,0.0005381
847,40.6725,-73.9364,1,8,3,5,0.0005042
854,40.6955,-73.9116,1,3,22,-19,0.000840877
856,40.7373,-73.8641,1,13,18,-5,0.00141053
857,40.6845,-73.9201,1,3,9,-6,0.000680833
859,40.6427,-73.961,1,20,19,1,5.5e-05
862,40.7564,-73.875,1,13,21,-8,0.000647813
865,40.7488,-73.8945,1,4,3,1,4.9e-05
868,40.7327,-73.9583,1,29,28,1,1.5e-05
874,40.6571,-73.9501,1,17,2,15,0.000440744
880,40.7408,-73.9315,1,7,1,6,0.000438194
881,40.7672,-73.9374,1,25,2,23,0.00101635
883,40.7314,-73.9829,1,27,23,4,0.00068625
884,40.6752,-73.9061,1,9,16,-7,0.000604595
886,40.6881,-73.9269,1,5,5,0,0
890,40.7472,-73.8868,1,1,3,-2,0.000870417
892,40.6424,-73.9695,1,20,19,1,0.000434
893,40.7611,-73.917,1,12,14,-2,9.41667e-05
900,40.7444,-73.9317,1,3,14,-11,0.000730455
902,40.7245,-73.9819,1,81,76,5,0.000397333
903,40.7399,-73.8601,1,14,18,-4,0.000530583
907,40.7147,-73.9574,1,18,8,10,0.000936333
911,40.7584,-73.8782,1,17,12,5,0.00164617
912,40.6688,-73.9338,1,3,2,1,0.000341167
913,40.7647,-73.888,1,18,16,2,0.000439083
915,40.7464,-73.8832,1,0,20,-20,0.00146797
917,40.7578,-73.8489,1,14,1,13,0.000449462
920,40.7531,-73.928,1,5,9,-4,0.000331958
923,40.7497,-73.9521,1,33,3,30,0.00113351
924,40.6731,-73.9139,1,6,5,1,4.1e-05
930,40.6828,-73.9349,1,10,9,1,7.16667e-05
934,40.6623,-73.9376,1,19,13,6,0.000437056
937,40.7505,-73.8672,1,3,2,1,0.000182
938,40.7591,-73.919,1,14,8,6,0.000682778
940,40.6994,-73.9134,1,1,8,-7,0.00269145
941,40.6595,-73.9504,1,15,14,1,6e-05
942,40.741,-73.8536,1,3,18,-15,0.000737111
943,40.7627,-73.993,1,31,29,2,0.0001825
946,40.7435,-73.9244,1,1,13,-12,0.00139889
952,40.751,-73.938,1,0,6,-6,0.00260806
954,40.7445,-73.8976,1,11,3,8,0.000783833
955,40.7498,-73.8616,1,1,8,-7,0.0028919
957,40.7258,-73.9417,1,21,20,1,0.000256667
958,40.7458,-73.8643,1,14,3,11,0.000868318
960,40.7266,-73.9032,1,15,14,1,7.83333e-06
967,40.692,-73.9326,1,15,15,0,0
969,40.7315,-73.9002,1,10,17,-7,0.000847143
973,40.7476,-73.9788,1,8,4,4,0.00081875
974,40.7495,-73.9026,1,15,14,1,7.78333e-05
975,40.7633,-73.884,1,17,18,-1,3.91667e-05
977,40.7143,-73.9332,1,19,10,9,0.000353148
979,40.7093,-73.8944,1,5,19,-14,0.000778964
982,40.7054,-73.9253,1,12,7,5,0.000436567
992,40.7297,-73.9866,1,34,32,2,0.0004275
998,40.6849,-73.9149,1,6,19,-13,0.000921974
999,40.724,-73.9498,1,28,18,10,0.00026
1006,40.6936,-73.9252,1,21,14,7,0.00156452
1010,40.7596,-73.9143,1,18,11,7,0.00145376
1013,40.6966,-73.9006,1,10,15,-5,0.000553667
1014,40.6882,-73.9197,1,8,11,-3,0.000341111
1016,40.6981,-73.9027,1,14,17,-3,0.000370722
1019,40.6814,-73.9257,1,11,15,-4,0.000625583
1020,40.7529,-73.8754,1,4,23,-19,0.000883667
1022,40.7492,-73.9494,1,15,3,12,0.000893333
1024,40.7576,-73.8645,1,10,17,-7,0.000926286
1025,40.7339,-73.9013,1,16,18,-2,0.000677833
1031,40.7248,-73.9475,1,43,39,4,0.000492917
1034,40.7495,-73.8546,1,7,9,-2,0.000178417
1036,40.6705,-73.9308,1,18,14,4,0.000739542
1039,40.7548,-73.917,1,4,20,-16,0.000903135
1044,40.7256,-73.9042,1,18,13,5,0.000352867
1045,40.7122,-73.8911,1,23,11,12,0.000616236
1046,40.6899,-73.9146,1,14,6,8,0.00154479
1063,40.6785,-73.9137,1,13,13,0,0
1067,40.7534,-73.9124,1,12,9,3,0.000411444
1074,40.7177,-73.9405,1,13,15,-2,0.000643333
1079,40.734,-73.952,1,18,3,15,0.000659122
1082,40.7611,-73.8863,1,15,15,0,0
1085,40.7233,-73.9431,1,51,28,23,0.00259543
1090,40.7448,-73.9173,1,2,30,-28,0.00113478
1093,40.7455,-73.906,1,3,3,0,0
1108,40.7367,-73.8773,1,21,5,16,0.000980323
1120,40.7859,-73.9486,1,16,13,3,0.000102556
1126,40.7228,-73.957,1,36,18,18,0.000700556
1127,40.7518,-73.9482,1,12,2,10,0.000840167
1128,40.687,-73.9234,1,6,11,-5,0.000285
1129,40.7422,-73.9266,1,7,16,-9,0.000814167
1131,40.6846,-73.9093,1,1,11,-10,0.00109343
1134,40.7459,-73.8854,1,3,11,-8,0.000713792
1151,40.6972,-73.9067,1,10,12,-2,8.84167e-05
1152,40.6816,-73.9196,1,10,13,-3,0.000546111
1154,40.6882,-73.908,1,15,17,-2,0.000357167
1155,40.6462,-73.9307,1,19,14,5,0.0002626
1159,40.7523,-73.8809,1,11,13,-2,0.000240833
1161,40.7411,-73.8884,1,12,14,-2,0.000298167
1163,40.762,-73.8704,1,16,20,-4,0.000652375
1167,40.7616,-73.8817,1,17,11,6,0.000534778
1168,40.748,-73.882,1,1,10,-9,0.000770944
1173,40.7428,-73.883,1,23,10,13,0.000642487
1176,40.6708,-73.9507,1,16,15,1,0.000121667
1181,40.6685,-73.9228,1,7,11,-4,0.000154417
1184,40.7712,-73.917,1,10,2,8,0.00105312
1189,40.6906,-73.9118,1,12,10,2,0.000616667
1190,40.7671,-73.9622,1,23,5,18,0.00082213
1193,40.6435,-73.9864,1,19,17,2,0.000832167
1195,40.7547,-73.8918,1,6,15,-9,0.000785426
1198,40.7688,-73.9584,1,30,25,5,0.000118
1200,40.7003,-73.9503,1,22,1,21,0.00109265
1206,40.7371,-73.8561,1,15,19,-4,0.000749417
1207,40.743,-73.9356,1,19,11,8,0.00068875
1210,40.713,-73.9097,1,13,17,-4,0.000420875
1217,40.7405,-73.8565,1,11,17,-6,0.00202983
1218,40.7505,-73.9459,1,10,5,5,0.000967
1219,40.7447,-73.9354,1,30,7,23,0.000933188
1220,40.7575,-73.9016,1,9,12,-3,0.000273611
1224,40.6895,-73.9421,1,13,11,2,0.000445833
1225,40.7589,-73.8908,1,11,17,-6,0.000814278
1235,40.7587,-73.8753,1,9,18,-9,0.000918463
1236,40.7516,-73.915,1,18,0,18,0.00128444
1237,40.7642,-73.8812,1,14,16,-2,0.0001435
1246,40.7509,-73.8911,1,1,9,-8,0.00080375
1249,40.6971,-73.9157,1,3,14,-11,0.00085947
1261,40.648,-73.9318,1,25,6,19,0.000357939
1263,40.756,-73.8827,1,15,19,-4,0.000652208
1267,40.7067,-73.9612,1,9,2,7,0.00058319
1272,40.7457,-73.9819,1,10,6,4,0.000810417
1278,40.7212,-73.9418,1,12,16,-4,0.00055125
1281,40.7573,-73.9536,1,9,2,7,0.000746905
1282,40.7446,-73.906,1,17,11,6,0.000630889
1287,40.7601,-73.8974,1,14,11,3,0.000270333
1288,40.6999,-73.9117,1,0,5,-5,0.00322233
1291,40.738,-73.861,1,11,21,-10,0.000647517
1293,40.7408,-73.8498,1,12,22,-10,0.0036437
1294,40.7125,-73.941,1,27,23,4,0.0009625
1296,40.7456,-73.8882,1,8,7,1,0.000113333
1302,40.7677,-73.879,1,22,5,17,-0.00101907
1304,40.7386,-73.8855,1,17,1,16,0.000976177
1305,40.755,-73.8728,1,4,22,-18,0.000832
1306,40.6634,-73.9347,1,23,21,2,0.0003555
1312,40.7569,-73.9262,1,12,12,0,0
1313,40.6491,-73.9437,1,20,19,1,0.000230333
1315,40.7489,-73.8998,1,6,21,-15,0.00132628
1318,40.7501,-73.9135,1,10,1,9,0.00106444
1319,40.7673,-73.9939,1,30,13,17,0.000475098
1321,40.648,-73.9793,1,17,15,2,7.41667e-05
1324,40.6976,-73.931,1,10,10,0,0
1334,40.6832,-73.9117,1,5,16,-11,0.000736682
1335,40.7484,-73.8751,1,0,9,-9,0.000834463
1338,40.7621,-73.895,1,14,2,12,0.000753292
1346,40.6715,-73.9143,1,15,1,14,0.000998536
1348,40.7657,-73.8701,1,21,10,11,0.000473045
1349,40.7726,-73.9327,1,13,4,9,0.000428481
1350,40.7662,-73.8756,1,22,8,14,0.00084431
1354,40.7645,-73.8737,1,17,9,8,0.000311688
1357,40.7381,-73.881,1,19,8,11,0.000704455
1370,40.674,-73.9671,1,6,3,3,0.000376111
1374,40.7878,-73.9536,1,6,4,2,0.000396667
1376,40.6615,-73.9397,1,18,9,9,0.000772981
1377,40.6467,-73.9664,1,16,13,3,0.000319833
1379,40.6956,-73.8993,1,6,18,-12,0.000861847
1380,40.7107,-73.9052,1,3,15,-12,0.000744556
1381,40.7207,-73.9863,1,39,37,2,0.000171667
1382,40.698,-73.9708,1,18,12,6,0.000562778
1384,40.7403,-73.9289,1,5,11,-6,0.000269083
1385,40.7274,-73.9938,1,15,10,5,0.00108533
1391,40.7428,-73.8623,1,11,16,-5,0.000260633
1393,40.7374,-73.918,1,8,8,0,0
1395,40.7495,-73.9183,1,4,16,-12,0.000989583
1397,40.7263,-73.9898,1,66,61,5,0.000167
1399,40.7617,-73.9866,1,11,9,2,0.000240833
1402,40.7485,-73.9413,1,13,13,0,0
1403,40.7586,-73.9751,1,3,0,3,0.000655778
1404,40.6945,-73.958,1,21,20,1,1.95e-05
1405,40.6849,-73.923,1,5,12,-7,0.000456429
1406,40.7526,-73.8954,1,14,18,-4,0.000453292
1407,40.7683,-73.9926,1,16,12,4,0.00019
1412,40.7469,-73.9208,1,2,15,-13,0.000781859
1415,40.7411,-73.921,1,2,20,-18,0.000723139
1416,40.7574,-73.9047,1,5,23,-18,0.00959324
1428,40.7174,-73.9802,1,38,36,2,0.000860833
1432,40.7207,-73.9852,1,70,68,2,0.000386667
1437,40.7519,-73.9335,1,8,5,3,0.000385
1445,40.7079,-73.9109,1,8,13,-5,0.000818
1446,40.7103,-73.8996,1,3,3,0,0
1474,40.7417,-73.9942,1,17,11,6,0.000338333
1477,40.7465,-73.9322,1,7,0,7,0.000622476
1479,40.7611,-73.8884,1,17,16,1,5.65e-05
1481,40.7596,-73.9271,1,15,8,7,0.00130714
1482,40.7091,-73.9216,1,23,13,10,0.000731833
1483,40.7489,-73.8737,1,0,9,-9,0.000815
1485,40.7434,-73.8513,1,15,12,3,0.000193778
1486,40.6947,-73.9066,1,13,5,8,0.000863688
1488,40.757,-73.8561,1,19,21,-2,0.000484167
1489,40.7474,-73.9478,1,7,5,2,0.000278333
1490,40.7086,-73.915,1,13,9,4,0.0006625
1493,40.6954,-73.9495,1,9,3,6,0.000872222
1495,40.7494,-73.8871,1,6,17,-11,0.000796136
1499,40.7046,-73.9105,1,9,11,-2,0.00027325
1501,40.7159,-73.906,1,13,10,3,0.000251889
1506,40.7144,-73.901,1,17,15,2,0.000695333
1509,40.71,-73.9112,1,4,4,0,0
1517,40.7448,-73.8938,1,6,13,-7,0.000449476
1520,40.7544,-73.8783,1,19,21,-2,0.000510833
1521,40.7148,-73.909,1,14,20,-6,0.000612861
1522,40.7389,-73.8637,1,6,12,-6,0.00022275
1523,40.7502,-73.92,1,11,5,6,0.000884194
1524,40.7572,-73.9218,1,18,12,6,0.000344444
1540,40.759,-73.8698,1,9,19,-10,0.000865317
1541,40.6833,-73.9171,1,8,17,-9,0.00105352
1547,40.7402,-73.9354,1,3,2,1,0.0003915
1564,40.6569,-73.9533,1,14,13,1,0.000118667
1571,40.7458,-73.9508,1,6,11,-5,0.0004026
1572,40.7253,-73.9368,1,8,11,-3,0.000171111
1573,40.7011,-73.9179,1,17,13,4,0.000531708
1577,40.7012,-73.8904,1,16,12,4,0.00155792
1578,40.7129,-73.9659,1,36,27,9,0.00182296
1582,40.6546,-73.9472,1,11,2,9,0.000969259
1585,40.7689,-73.8683,1,21,14,7,0.000351357
1586,40.7515,-73.8557,1,3,6,-3,0.000338167
1591,40.7008,-73.9364,1,18,7,11,0.00234379
1593,40.7223,-73.9389,1,16,23,-7,0.000625952
1594,40.7241,-73.9557,1,48,11,37,0.000974099
1596,40.7199,-73.9639,1,41,40,1,0.000283333
1597,40.7363,-73.8675,1,20,2,18,0.000770787
1599,40.7561,-73.8608,1,16,21,-5,0.000546133
1600,40.7056,-73.9025,1,2,17,-15,0.000679222
1601,40.6603,-73.9362,1,19,12,7,0.000645833
1602,40.7494,-73.8579,1,9,6,3,0.0003045
1604,40.7225,-73.9085,1,14,8,6,0.000315
1620,40.7514,-73.8624,1,11,5,6,0.000756
1625,40.6512,-73.9458,1,14,5,9,0.000459852
1626,40.6597,-73.9452,1,23,8,15,0.000496211
1627,40.7394,-73.8741,1,19,14,5,-0.00417967
1629,40.6912,-73.9169,1,5,10,-5,0.000225667
1634,40.7277,-73.944,1,25,18,7,0.000739762
1635,40.6933,-73.9538,1,12,9,3,0.000319444
1642,40.76,-73.8622,1,4,15,-11,0.000835197
1643,40.7098,-73.9173,1,26,25,1,0.00158083
1647,40.7192,-73.9524,1,23,5,18,0.000809907
1649,40.7018,-73.9062,1,2,16,-14,0.0003235
1651,40.7365,-73.87,1,24,1,23,0.00108659
1652,40.7413,-73.938,1,9,12,-3,0.000127778
1657,40.7495,-73.9773,1,30,22,8,0.000260417
1660,40.6737,-73.9085,1,18,8,10,0.000468083
1663,40.7011,-73.9332,1,19,18,1,2.5e-05
1668,40.7522,-73.9359,1,1,3,-2,0.00104583
1670,40.7269,-73.9586,1,31,30,1,0.00015
1673,40.7164,-73.9482,1,20,20,0,0
1677,40.6771,-73.9008,1,14,5,9,0.000891907
1680,40.7505,-73.8977,1,18,12,6,0.000450639
1681,40.7401,-74.0053,1,26,24,2,0.0001825
1682,40.7303,-73.9539,1,22,20,2,0.0008425
1683,40.7409,-73.9027,1,17,25,-8,0.00116931
1687,40.7432,-73.908,1,9,15,-6,0.000451694
1693,40.7475,-73.8937,1,0,7,-7,0.00157119
1698,40.7623,-73.9879,1,18,9,9,0.000506481
1700,40.6962,-73.9437,1,13,1,12,0.00184042
1704,40.7138,-73.9351,1,15,5,10,0.000810667
1709,40.7577,-73.9077,1,9,18,-9,0.000580056
1712,40.6786,-73.9037,1,1,6,-5,0.00169517
1713,40.759,-73.9938,1,24,20,4,0.000691667
1714,40.7044,-73.9284,1,18,19,-1,0.0001685
1715,40.7382,-73.9274,1,9,15,-6,0.000304444
1716,40.7126,-73.9626,1,21,18,3,0.000753333
1717,40.692,-73.9262,1,10,19,-9,0.000682778
1718,40.7471,-73.855,1,9,14,-5,0.000162033
1723,40.7471,-73.929,1,7,2,5,0.000685267
1725,40.7199,-73.9056,1,19,15,4,-0.00441262
1728,40.6904,-73.9037,1,20,19,1,0.000109
1731,40.7491,-73.8917,1,0,3,-3,0.00198
1732,40.7062,-73.9339,1,28,16,12,0.000985972
1735,40.6988,-73.9007,1,5,13,-8,0.000998938
1745,40.7477,-73.8665,1,4,19,-15,0.000817611
1747,40.6808,-73.9461,1,6,4,2,0.0003325
1750,40.7372,-73.8662,1,10,2,8,0.000519354
1753,40.6515,-73.9628,1,14,11,3,0.000308889
1757,40.6692,-73.9554,1,17,10,7,0.000468095
1758,40.7721,-73.8952,1,20,13,7,0.000505405
1759,40.7488,-73.8628,1,9,4,5,0.00104733
1761,40.6845,-73.9322,1,8,10,-2,0.000126667
1763,40.7547,-73.8946,1,14,14,0,0
1764,40.7505,-73.9051,1,8,10,-2,8.43333e-05
1767,40.7486,-73.8762,1,0,9,-9,0.00228889
1771,40.7056,-73.9215,1,11,14,-3,0.000362222
1774,40.7596,-73.8822,1,10,17,-7,0.0013771
1775,40.7573,-73.8902,1,19,20,-1,0.000313333
1778,40.7615,-73.9901,1,38,34,4,0.000357083
1782,40.7348,-73.8743,1,36,18,18,0.000714759
1783,40.693,-73.916,1,13,12,1,0.00021
1786,40.7081,-73.8955,1,6,11,-5,0.000559767
1795,40.7453,-73.9219,1,11,17,-6,0.000735278
1796,40.714,-73.9279,1,16,7,9,0.000628389
1797,40.7054,-73.9298,1,18,7,11,0.000904697
1800,40.699,-73.9152,1,5,16,-11,0.000740773
1804,40.741,-73.8803,1,23,6,17,0.000631824
1806,40.7539,-73.8839,1,5,20,-15,0.000692611
1817,40.7839,-73.9127,1,14,9,5,0.000641267
1818,40.6749,-73.9112,1,15,16,-1,9.41667e-05
1819,40.7064,-73.9194,1,12,14,-2,0.00083525
1820,40.7396,-73.9452,1,16,3,13,0.000712
1821,40.6905,-73.9235,1,11,6,5,0.000402667
1823,40.7446,-73.9114,1,0,14,-14,0.0012176
1825,40.6828,-73.9062,1,0,8,-8,0.00157515
1827,40.7317,-73.9016,1,17,18,-1,0.0006605
1828,40.751,-73.908,1,17,16,1,0.000102167
1829,40.6673,-73.934,1,15,8,7,0.001165
1832,40.661,-73.948,1,22,21,1,0.00145833
1833,40.702,-73.9238,1,19,21,-2,0.0004275
1834,40.6472,-73.9435,1,17,12,5,0.000183633
1836,40.6893,-73.9095,1,14,9,5,0.000470333
1838,40.6915,-73.9215,1,8,15,-7,0.000418333
1839,40.7358,-73.9018,1,16,18,-2,0.000397833
1850,40.7453,-73.9906,1,19,12,7,0.000460714
1854,40.6558,-73.9432,1,9,3,6,0.000590278
1855,40.7424,-73.8725,1,19,10,9,0.00070413
1856,40.7407,-73.9816,1,30,27,3,0.000828333
1860,40.6466,-73.954,1,18,15,3,0.00169639
1861,40.7699,-73.9184,1,9,6,3,0.000433889
1868,40.7547,-73.9974,1,12,7,5,0.000571
1869,40.7153,-73.9602,1,32,15,17,0.000338137
1870,40.7058,-73.9129,1,14,10,4,0.000574167
1871,40.718,-73.9182,1,8,5,3,0.000253111
1873,40.7041,-73.9041,1,9,17,-8,0.00128038
1877,40.7291,-73.9578,1,28,25,3,0.000925
1883,40.7023,-73.9014,1,12,16,-4,0.000715417
1885,40.7104,-73.9653,1,32,23,9,0.00169111
1888,40.7729,-73.8968,1,18,17,1,0.000296833
1890,40.6993,-73.923,1,16,17,-1,9.33333e-05
1892,40.7223,-73.9121,1,19,14,5,0.000384967
1894,40.717,-73.9449,1,14,15,-1,0.000396667
1896,40.7394,-73.9213,1,14,15,-1,0.000248333
1898,40.7421,-73.8542,1,19,12,7,0.000905214
1900,40.7139,-73.903,1,13,18,-5,0.0007586
1905,40.7422,-73.9294,1,5,1,4,0.000532917
1909,40.6563,-73.9365,1,17,11,6,0.000575944
1911,40.7216,-73.9455,1,17,14,3,0.000732222
1912,40.7182,-73.9552,1,43,17,26,0.000997372
1913,40.7558,-73.9127,1,8,5,3,0.000375556
1921,40.7558,-73.8662,1,3,18,-15,0.00132402
1929,40.7614,-73.8603,1,22,13,9,0.000314204
1930,40.7104,-73.9471,1,16,14,2,0.000306667
1938,40.7575,-73.8684,1,4,19,-15,0.000953989
1941,40.7458,-73.8594,1,15,6,9,0.000667333
1948,40.7442,-73.9712,1,26,14,12,0
1953,40.721,-73.907,1,15,13,2,7.85e-05
1956,40.7496,-73.8668,1,1,1,0,0
1967,40.7462,-73.8776,1,10,17,-7,0.000700762
1968,40.7415,-73.8748,1,17,4,13,0.000672385
1969,40.7376,-73.8596,1,20,21,-1,6.75e-05
1972,40.7734,-73.9138,1,14,8,6,0.000646639
1977,40.7027,-73.9498,1,8,5,3,0.000130222
1984,40.7315,-73.9853,1,45,40,5,0.000610667
1985,40.7602,-73.8777,1,18,20,-2,0.000568083
1986,40.7016,-73.9088,1,10,14,-4,0.000265333
1990,40.7613,-73.8667,1,9,15,-6,0.000482528
1991,40.745,-73.9036,1,4,5,-1,0.000503333
1994,40.6865,-73.9132,1,4,14,-10,0.000793033
2000,40.7429,-73.9139,1,8,18,-10,0.0007343
2002,40.7357,-73.9039,1,12,5,7,0.000332024
2004,40.7459,-73.8992,1,20,7,13,0.000558641
2011,40.7445,-73.9141,1,17,23,-6,0.0009025
2018,40.7539,-73.915,1,13,21,-8,0.000695667
2020,40.7087,-73.9259,1,14,9,5,0.000353
2023,40.7055,-73.9394,1,14,18,-4,0.000597167
2025,40.6685,-73.9191,1,6,2,4,0.000951667
2026,40.724,-73.9085,1,15,11,4,0.000320125
2029,40.7609,-73.8731,1,19,19,0,0
2030,40.7107,-73.9337,1,21,6,15,0.00121078
2031,40.7169,-73.902,1,13,15,-2,0.000313
2033,40.7428,-73.8958,1,6,14,-8,0.000745729
2035,40.7454,-73.8558,1,14,20,-6,0.000746139
2038,40.6863,-73.9358,1,18,15,3,0.000252778
2042,40.7425,-73.8781,1,19,23,-4,0.000733667
2053,40.6943,-73.9463,1,17,9,8,0.00249063
2056,40.7456,-73.9457,1,25,5,20,0.00125617
2059,40.7757,-73.9507,1,28,22,6,0.000808056
2063,40.7429,-73.9892,1,11,7,4,0.000766667
2066,40.7533,-73.9059,1,12,8,4,0.000798042
2068,40.7448,-73.9384,1,10,5,5,0.000772
2069,40.7141,-73.9523,1,16,13,3,0.000329444
2072,40.7514,-74.0052,1,33,28,5,0.000394667
2075,40.7532,-73.853,1,27,6,21,0.000519103
2081,40.7303,-73.9042,1,14,3,11,0.00120036
2082,40.7781,-73.8996,1,11,3,8,0.000731458
2086,40.7203,-73.9571,1,30,21,9,0.000197593
2095,40.6995,-73.8887,1,14,7,7,0.000659024
2099,40.7433,-73.8908,1,12,6,6,0.000849444
2100,40.6972,-73.8936,1,12,15,-3,0.000636667
2103,40.7111,-73.903,1,11,17,-6,0.000871167
2104,40.7438,-73.9418,1,7,0,7,0.000869071
2107,40.6776,-73.9556,1,12,8,4,0.000452083
2109,40.7557,-73.9034,1,8,15,-7,0.000720214
1,40.6444,-73.9843,2,12,20,-8,0.000687437
2,40.766,-73.9831,2,2,35,-33,0.00116515
3,40.6854,-73.9743,2,4,5,-1,8.5e-05
7,40.737,-73.9901,2,12,16,-4,0.0004
15,40.6491,-74.0095,2,9,19,-10,0.000605533
16,40.7241,-74.0097,2,22,24,-2,0.0001175
17,40.7345,-73.9907,2,4,9,-5,0.002098
21,40.6933,-73.977,2,51,42,9,0.00116685
22,40.7252,-73.9777,2,13,39,-26,0.000812949
23,40.6867,-73.9474,2,5,10,-5,0.000774
24,40.645,-73.9582,2,25,10,15,0.00118378
25,40.6794,-73.968,2,4,5,-1,0.000455
29,40.7163,-74.0091,2,13,40,-27,0.000684691
31,40.7249,-73.9921,2,36,21,15,0.000550778
35,40.7365,-73.9781,2,11,20,-9,0.00102204
37,40.6637,-73.963,2,0,3,-3,0.00160139
40,40.7133,-74.0094,2,6,6,0,0
41,40.7204,-73.9617,2,0,37,-37,0.00105644
48,40.7012,-74.0123,2,40,16,24,0.000342222
52,40.7091,-74.0104,2,19,6,13,0.000205641
54,40.6868,-73.9797,2,13,8,5,0.000227
55,40.6758,-73.9562,2,9,20,-11,0.000600758
59,40.7208,-73.9779,2,29,43,-14,0.000924167
62,40.6485,-73.9706,2,26,27,-1,5.91667e-05
65,40.6694,-73.9451,2,2,15,-13,0.00121449
66,40.7549,-73.9845,2,5,9,-4,0.000682083
71,40.6772,-74.0157,2,15,30,-15,0.000820433
72,40.6854,-73.9913,2,17,14,3,0.000206667
74,40.6413,-74.0177,2,25,14,11,0.000589152
76,40.738,-73.9964,2,6,48,-42,0.000741579
82,40.7222,-73.9837,2,49,73,-24,0.000415139
85,40.6541,-74.0042,2,17,16,1,0.000136667
89,40.7131,-73.9945,2,31,34,-3,0.000587222
90,40.6879,-73.9894,2,29,4,25,0.000618867
91,40.6792,-73.9588,2,8,15,-7,0.000487619
96,40.6487,-73.9463,2,12,20,-8,0.000655396
100,40.6495,-73.9541,2,11,15,-4,0.000761667
101,40.6852,-73.9411,2,11,14,-3,0.000490556
105,40.7014,-73.9867,2,3,3,0,0
107,40.6743,-74.0019,2,11,18,-7,0.000520048
108,40.6581,-73.9567,2,6,16,-10,0.000979867
112,40.6687,-73.9618,2,2,16,-14,0.000454762
113,40.7593,-73.9886,2,1,50,-49,0.00141401
115,40.7221,-73.9972,2,18,12,6,0.000616944
119,40.7342,-73.9869,2,12,43,-31,0.000436828
121,40.6993,-73.9533,2,14,18,-4,0.000441375
123,40.7356,-73.9587,2,20,23,-3,0.000198889
127,40.7485,-73.9826,2,0,36,-36,0.00113926
130,40.6958,-73.9736,2,16,18,-2,0.0006275
131,40.6962,-73.9914,2,1,30,-29,0.00114351
135,40.7158,-73.9942,2,21,22,-1,0.00012
136,40.6602,-73.991,2,18,17,1,5e-06
139,40.6938,-73.9311,2,1,16,-15,0.00146857
142,40.6752,-73.9815,2,14,24,-10,0.000904
147,40.6976,-73.9489,2,4,4,0,0
153,40.6924,-73.9895,2,4,16,-12,0.00148139
159,40.7418,-74.0015,2,5,65,-60,0.000829889
169,40.7354,-74.0048,2,74,75,-1,5.16667e-05
170,40.7046,-74.0136,2,13,2,11,0.000769091
172,40.677,-73.9658,2,6,10,-4,0.000575
175,40.7488,-73.9701,2,19,53,-34,0.000869167
177,40.6659,-73.926,2,15,19,-4,0.000300417
180,40.6357,-74.02,2,12,18,-6,0.000663389
182,40.7209,-73.9809,2,41,52,-11,0.000506061
183,40.7001,-73.9862,2,42,27,15,0.000345556
186,40.6401,-74.0157,2,3,29,-26,0.000855462
192,40.7502,-73.9712,2,12,38,-26,0.000836603
193,40.6445,-73.9449,2,16,16,0,0
195,40.6851,-74.0254,2,31,17,14,0.000182071
199,40.6468,-73.9493,2,17,18,-1,0.000293167
201,40.7251,-73.9813,2,30,50,-20,0.000845083
203,40.7417,-73.9781,2,17,28,-11,0.000544545
204,40.7274,-73.9884,2,67,39,28,0.000482333
206,40.6923,-74.0149,2,13,26,-13,0.000501231
207,40.691,-73.992,2,16,13,3,5.38889e-05
210,40.7057,-74.0168,2,31,30,1,6.33333e-05
215,40.6562,-74.0093,2,40,1,39,0.000945192
216,40.7025,-73.9868,2,0,3,-3,0.00265778
220,40.6765,-73.9785,2,32,37,-5,0.000602667
225,40.7435,-74.0037,2,20,36,-16,0.000874167
230,40.7176,-74.0055,2,5,46,-41,0.000615366
231,40.6764,-73.9529,2,5,7,-2,0.000203333
232,40.7019,-74.0139,2,62,5,57,0.000728801
234,40.6516,-73.9353,2,9,19,-10,0.00041725
235,40.7096,-74.0066,2,9,34,-25,0.0010938
238,40.7465,-73.9973,2,7,59,-52,0.00105897
239,40.6516,-73.9722,2,27,2,25,0.000870667
240,40.6425,-74.0061,2,5,9,-4,0.000225417
241,40.682,-73.9908,2,23,23,0,0
251,40.6793,-73.9752,2,14,3,11,0.00124106
255,40.748,-73.9966,2,13,27,-14,0.000717143
256,40.7397,-73.991,2,33,9,24,0.00143181
258,40.6599,-73.9775,2,17,21,-4,0.000311125
260,40.7258,-73.9742,2,10,36,-26,0.000986667
268,40.6794,-74.0079,2,12,12,0,0
269,40.672,-73.9254,2,5,17,-12,0.00129844
274,40.7431,-73.9822,2,3,45,-42,0.0011946
276,40.692,-73.9654,2,38,17,21,0.000912857
277,40.6871,-74.0168,2,10,23,-13,0.000305744
279,40.6603,-73.9604,2,6,8,-2,0.000149833
280,40.7,-73.9744,2,2,1,1,0
285,40.7632,-73.9784,2,0,4,-4,0.00334667
289,40.6909,-73.9961,2,17,18,-1,0.000158333
292,40.6464,-74.0231,2,24,1,23,0.000811674
294,40.6876,-74.0016,2,17,17,0,0
296,40.7087,-73.9449,2,10,21,-11,0.000538182
300,40.6487,-73.9522,2,16,18,-2,0.000173083
301,40.7198,-74.0052,2,21,14,7,0.00047881
302,40.7099,-73.9401,2,11,18,-7,0.000843381
307,40.7359,-73.9821,2,20,71,-51,0.000784118
308,40.7151,-73.9842,2,75,65,10,0.00224
311,40.6747,-73.9979,2,7,4,3,0.000705556
315,40.6737,-73.922,2,8,17,-9,0.000651778
322,40.7028,-73.9938,2,12,13,-1,0.000138333
325,40.7593,-73.9676,2,3,15,-12,0.000922222
326,40.7653,-73.9819,2,1,13,-12,0.00281736
330,40.6716,-73.9631,2,0,5,-5,0.00169567
342,40.7467,-74.0078,2,45,5,40,0.00112171
343,40.6735,-73.9336,2,0,15,-15,0.000764889
345,40.6961,-73.9675,2,47,33,14,0.000585
348,40.6736,-74.012,2,16,9,7,0.000452881
349,40.7348,-73.9921,2,30,13,17,0.00123333
351,40.6961,-73.978,2,23,48,-25,0.00076016
352,40.6394,-74.0268,2,17,17,0,0
354,40.6795,-73.9471,2,2,20,-18,0.000820824
357,40.6979,-73.9699,2,7,20,-13,0.00162936
358,40.7634,-73.9827,2,5,19,-14,0.000916548
360,40.6998,-73.9714,2,1,2,-1,0.000566667
361,40.7114,-74.0148,2,38,26,12,0.000441389
366,40.7191,-73.9997,2,26,5,21,0.000873651
370,40.7667,-73.9906,2,7,22,-15,0.000833778
383,40.7036,-74.0067,2,19,42,-23,0.00145188
384,40.6631,-73.9539,2,7,13,-6,0.000833167
388,40.6511,-73.9419,2,13,21,-8,0.000850375
391,40.7279,-74.0054,2,23,18,5,0.000241
392,40.7378,-73.9999,2,15,28,-13,0.000557436
397,40.7072,-73.9237,2,27,24,3,-0.111136
398,40.7637,-73.9852,2,11,27,-16,0.00126906
399,40.7397,-73.9946,2,8,11,-3,0.000347778
401,40.7211,-73.9919,2,55,50,5,0.000207667
406,40.6887,-73.9552,2,12,14,-2,0.000231667
407,40.64,-74.0232,2,22,9,13,0.000273577
411,40.7156,-73.987,2,61,62,-1,6.16667e-05
412,40.6457,-73.9433,2,13,19,-6,0.00023175
413,40.637,-74.0221,2,17,17,0,0
415,40.6595,-73.9801,2,19,19,0,0
422,40.6864,-73.9568,2,17,18,-1,8.66667e-05
428,40.7107,-74.0035,2,15,18,-3,0.000153889
429,40.7173,-73.9907,2,41,32,9,0.00115111
430,40.685,-73.9944,2,22,19,3,0.000215
434,40.7469,-74.0045,2,13,69,-56,0.00103464
436,40.7147,-74.0091,2,22,33,-11,0.000479848
440,40.7205,-73.959,2,30,44,-14,0.00105238
441,40.7169,-74.0065,2,32,21,11,0.000535303
443,40.6897,-73.9335,2,7,11,-4,0.000772083
446,40.7332,-73.9757,2,31,52,-21,0.000912698
448,40.7546,-73.9918,2,9,52,-43,0.000610388
450,40.7298,-73.9746,2,26,34,-8,0.000339375
452,40.6686,-73.987,2,20,5,15,0.000640356
457,40.7457,-74.0051,2,14,41,-27,0.000755741
458,40.7313,-73.9885,2,48,40,8,0.000315208
459,40.7237,-73.9757,2,22,24,-2,0.000240833
461,40.6626,-73.9456,2,20,17,3,-0.0478112
464,40.6848,-73.9992,2,20,17,3,0.000777778
465,40.6454,-73.9327,2,13,18,-5,0.000460667
466,40.757,-73.9826,2,8,15,-7,0.000755
469,40.7037,-73.9543,2,1,1,0,0
470,40.6438,-73.9687,2,13,15,-2,0.000333167
471,40.6933,-73.9285,2,7,20,-13,0.000746359
472,40.7559,-74.0021,2,17,3,14,0.000653214
481,40.7599,-73.9765,2,1,7,-6,0.000848889
484,40.7075,-74.0011,2,19,20,-1,8.66667e-05
485,40.7469,-74.0082,2,0,6,-6,0.00233333
487,40.7072,-74.0089,2,7,48,-41,0.000855081
488,40.6382,-74.0247,2,21,23,-2,0.00022375
492,40.7444,-73.9559,2,32,61,-29,0.00062954
497,40.6417,-73.9636,2,19,22,-3,0.000521722
500,40.7521,-73.9678,2,19,60,-41,0.0012689
501,40.7305,-73.9991,2,35,56,-21,0.000912302
502,40.6426,-74.0169,2,6,19,-13,0.000885577
504,40.7142,-73.9811,2,27,32,-5,0.000958667
505,40.679,-74.0112,2,31,37,-6,0.000489028
506,40.6882,-73.9668,2,10,15,-5,0.000453
507,40.7149,-74.0112,2,31,6,25,0.00065
509,40.646,-73.981,2,17,17,0,0
511,40.7081,-74.0136,2,0,53,-53,0.00114704
513,40.6596,-73.9951,2,18,8,10,0.000450717
514,40.7462,-73.9886,2,17,19,-2,0.000354167
516,40.7572,-73.9781,2,0,8,-8,0.00124167
517,40.6819,-73.9594,2,26,27,-1,0.000226667
518,40.6777,-73.9936,2,41,46,-5,0.000345933
523,40.7241,-73.979,2,21,23,-2,0.000185
527,40.7115,-73.9867,2,23,28,-5,0.000899
528,40.7597,-73.974,2,2,2,0,0
530,40.7258,-74.0077,2,36,36,0,0
531,40.677,-73.9865,2,22,9,13,0.00057359
532,40.7399,-73.9896,2,6,12,-6,0.00128056
533,40.7634,-73.9772,2,1,13,-12,0.00153014
535,40.6408,-74.011,2,4,18,-14,0.00081456
536,40.7176,-74.0159,2,17,15,2,0.0001475
537,40.7178,-73.9932,2,42,14,28,0.000827619
539,40.7085,-73.9641,2,17,17,0,0
541,40.6743,-73.9503,2,10,10,0,0
550,40.7541,-73.9961,2,2,9,-7,0.000539762
552,40.6901,-73.9479,2,8,15,-7,0.000655
555,40.7354,-73.9943,2,11,26,-15,0.000588333
557,40.6772,-73.9228,2,8,17,-9,0.000562796
559,40.6871,-73.9301,2,9,16,-7,0.000802619
561,40.7634,-73.9967,2,4,6,-2,0.0006325
564,40.6618,-73.9344,2,17,17,0,0
570,40.6747,-73.9251,2,14,19,-5,0.000626867
578,40.694,-73.9947,2,11,19,-8,0.000424167
581,40.6829,-73.9932,2,21,23,-2,0.00032
582,40.7026,-73.9894,2,0,20,-20,0.00172658
584,40.6533,-73.9617,2,14,18,-4,0.00042375
589,40.681,-73.95,2,4,7,-3,0.000241667
597,40.6609,-73.9868,2,10,18,-8,0.00081875
598,40.7636,-73.9892,2,14,16,-2,0.000104167
599,40.7198,-73.9787,2,45,36,9,0.00155296
601,40.7188,-73.996,2,27,37,-10,0.0009215
602,40.6751,-73.9472,2,13,13,0,0
605,40.7391,-73.9797,2,11,57,-46,0.000801159
606,40.7546,-73.9952,2,4,27,-23,0.000844493
610,40.7194,-74.0025,2,66,22,44,0.000590152
612,40.745,-73.9575,2,6,22,-16,0.000425208
618,40.7432,-73.9745,2,39,15,24,3.88889e-05
622,40.6626,-73.9986,2,21,18,3,0.000188778
626,40.655,-73.9377,2,18,19,-1,0.000148
629,40.6513,-73.9382,2,8,22,-14,0.000643071
631,40.6399,-74.0198,2,14,13,1,0.0002285
632,40.6875,-73.9727,2,7,26,-19,0.000146404
634,40.7322,-73.9817,2,14,40,-26,0.00109872
637,40.6538,-73.9527,2,12,16,-4,0.000572542
638,40.6601,-73.9986,2,15,9,6,0.00046125
640,40.6765,-73.9594,2,17,19,-2,0.000285
643,40.7526,-73.9968,2,0,30,-30,0.00193167
644,40.6397,-73.9681,2,16,17,-1,0.000396667
646,40.7117,-73.9919,2,26,20,6,0.00168333
648,40.6512,-74.0114,2,23,6,17,-0.00139786
649,40.6434,-74.0119,2,2,23,-21,0.000712444
650,40.6518,-73.9652,2,17,25,-8,0.000797708
651,40.7302,-73.991,2,56,18,38,0.00151886
652,40.6427,-74.0094,2,3,12,-9,0.000275907
653,40.642,-73.9811,2,0,7,-7,0.000580548
656,40.6405,-74.0256,2,19,15,4,0.000168792
657,40.6664,-73.9535,2,12,16,-4,0.000794167
659,40.734,-74.0029,2,36,52,-16,0.000719479
661,40.6377,-74.0178,2,15,21,-6,0.00098725
663,40.7262,-73.9838,2,26,34,-8,0.000516667
664,40.681,-73.9991,2,6,9,-3,0.000361111
665,40.7527,-74.0024,2,18,41,-23,0.000980145
666,40.7448,-73.9992,2,19,59,-40,0.00101625
667,40.7129,-73.957,2,18,24,-6,0.000418611
672,40.6631,-73.9606,2,7,11,-4,0.000202917
673,40.6751,-73.9878,2,72,2,70,0.000936152
677,40.751,-73.9877,2,4,25,-21,0.00107143
678,40.6403,-73.966,2,17,23,-6,0.000566472
679,40.7467,-73.9939,2,5,31,-26,0.000877372
683,40.6758,-73.9633,2,12,3,9,0.00112315
684,40.6447,-73.9745,2,13,21,-8,0.000718542
693,40.7478,-74.0006,2,38,63,-25,0.000637
700,40.6464,-74.0093,2,13,24,-11,0.000858667
703,40.6954,-73.9322,2,14,28,-14,0.000855238
704,40.7115,-74.0055,2,11,9,2,0.000135
706,40.6493,-74.0201,2,17,3,14,0.00107349
708,40.7279,-73.9541,2,9,11,-2,0.000239167
712,40.7175,-74.0132,2,61,1,60,0.00110475
725,40.7512,-73.9714,2,12,29,-17,0.000717647
732,40.6548,-74.0144,2,18,0,18,0.000942583
734,40.7032,-73.9406,2,20,34,-14,0.000860702
738,40.6947,-73.9836,2,25,37,-12,0.00108528
740,40.6935,-73.9819,2,20,35,-15,0.000724033
743,40.6669,-73.9425,2,8,10,-2,0.000201667
747,40.6525,-74.0089,2,19,6,13,-0.001045
752,40.7424,-73.9973,2,13,5,8,0.0006075
758,40.6626,-73.9956,2,12,17,-5,0.000384
763,40.741,-74.0017,2,27,28,-1,0.00016
768,40.7568,-73.9997,2,4,30,-26,0.000838397
771,40.6559,-73.9407,2,26,6,20,0.000757167
772,40.6876,-73.9697,2,31,27,4,5e-05
773,40.6577,-74.0011,2,15,5,10,0.00081705
777,40.725,-73.9907,2,74,81,-7,0.000620952
778,40.7379,-73.9851,2,9,36,-27,0.000928519
779,40.6809,-73.9757,2,11,5,6,0.000546944
781,40.6474,-73.9593,2,13,18,-5,0.000933633
782,40.7047,-74.008,2,26,22,4,0.00038
783,40.6724,-73.9309,2,12,18,-6,0.00070325
787,40.7277,-73.991,2,36,29,7,0.000253571
796,40.7477,-73.9849,2,22,35,-13,0.000563846
799,40.7535,-73.979,2,1,6,-5,0.00209233
801,40.7362,-74.0086,2,17,25,-8,0.000343333
803,40.6739,-73.9603,2,5,10,-5,0.000506333
805,40.7131,-73.9848,2,16,16,0,0
808,40.6885,-73.9648,2,26,30,-4,0.00043375
811,40.7326,-73.9901,2,24,13,11,0.000658485
814,40.6567,-73.9311,2,11,14,-3,0.000388667
818,40.6704,-73.9784,2,7,5,2,0.000125
819,40.6679,-73.9588,2,2,13,-11,0.000631909
826,40.7602,-73.9913,2,7,15,-8,0.000826458
828,40.7521,-73.9895,2,0,21,-21,0.00175937
829,40.7576,-73.9693,2,4,4,0,0
833,40.7449,-73.9535,2,1,22,-21,0.00104722
834,40.729,-73.994,2,20,11,9,0.000641852
837,40.7609,-74.0028,2,10,64,-54,0.00130463
839,40.7264,-74.0005,2,48,25,23,0.000583623
846,40.6444,-73.9659,2,21,3,18,0.000592241
848,40.7427,-73.9867,2,0,9,-9,0.00354444
851,40.7492,-73.9916,2,5,74,-69,0.00115314
858,40.6532,-73.9664,2,17,19,-2,0.000295833
864,40.6777,-73.969,2,6,17,-11,0.000547576
866,40.7278,-73.9856,2,55,62,-7,0.00098
869,40.6815,-73.9349,2,5,14,-9,0.000559167
870,40.7247,-73.9878,2,51,52,-1,0.000285
871,40.6658,-73.9569,2,9,24,-15,0.000875889
875,40.7372,-73.9812,2,8,37,-29,0.00105707
876,40.7054,-73.9498,2,5,13,-8,0.000601458
878,40.673,-73.9709,2,0,19,-19,0.00100211
882,40.7233,-73.9827,2,32,24,8,0.0015375
889,40.6844,-73.989,2,28,30,-2,0.000192417
895,40.6627,-73.9569,2,11,15,-4,0.000703333
898,40.6851,-73.9779,2,3,28,-25,0.000997667
899,40.7546,-73.9719,2,3,8,-5,0.00067
901,40.7058,-73.9464,2,9,16,-7,0.000515714
905,40.6502,-74.0156,2,18,2,16,0.00079826
906,40.7435,-74,2,5,74,-69,0.00105198
909,40.6936,-73.9622,2,43,47,-4,0.000258333
910,40.6764,-74.0032,2,14,15,-1,0.0001025
914,40.7553,-73.9676,2,8,35,-27,0.000864198
919,40.7127,-73.9878,2,36,35,1,0.000408333
922,40.7455,-74.002,2,18,46,-28,0.00084744
925,40.69,-73.9365,2,8,11,-3,0.000508889
928,40.6846,-73.9588,2,15,16,-1,0.000253333
935,40.7275,-73.9795,2,55,44,11,0.00114455
939,40.7231,-73.9858,2,57,62,-5,0.000537333
944,40.6917,-74,2,32,3,29,0.000853736
947,40.7462,-73.9718,2,20,24,-4,0.00033
948,40.6726,-73.9198,2,2,17,-15,0.000834567
949,40.7424,-73.9566,2,1,16,-15,0.00121411
950,40.684,-73.9498,2,10,10,0,0
951,40.6996,-73.9798,2,8,13,-5,0.000825
959,40.6609,-73.9831,2,9,16,-7,0.000437857
961,40.6976,-73.9934,2,4,7,-3,0.000358889
964,40.7504,-73.9834,2,4,7,-3,0.000478333
968,40.6909,-73.9552,2,14,21,-7,0.000830238
970,40.7164,-73.9659,2,0,38,-38,0.0014818
971,40.6831,-73.9979,2,21,32,-11,0.000443636
981,40.7548,-73.9882,2,0,41,-41,0.0017948
984,40.7571,-73.9721,2,2,5,-3,0.00120556
985,40.7203,-73.9988,2,33,26,7,0.000162619
987,40.6828,-73.9826,2,7,19,-12,0.00119833
988,40.6991,-73.9606,2,2,4,-2,0.000519167
989,40.6477,-73.9737,2,17,18,-1,0.000595
991,40.6723,-73.9476,2,8,11,-3,0.000361667
993,40.7322,-73.9889,2,20,32,-12,0.000235694
997,40.7071,-74.0073,2,24,20,4,0.000962917
1000,40.6731,-73.9691,2,0,46,-46,0.000894022
1001,40.7232,-74.0031,2,28,16,12,0.000616528
1004,40.7506,-73.9947,2,0,63,-63,0.00196481
1008,40.7425,-73.9489,2,3,20,-17,0.0010699
1012,40.7321,-74.0036,2,75,82,-7,0.000734286
1018,40.7607,-73.9804,2,1,4,-3,0.00191667
1021,40.7263,-73.9862,2,67,86,-19,0.000457018
1023,40.7564,-73.9941,2,9,23,-14,0.00105476
1026,40.6563,-73.9773,2,9,17,-8,0.000901042
1030,40.692,-73.9813,2,11,7,4,0.00055375
1035,40.6899,-73.981,2,58,11,47,0.00123869
1037,40.6804,-73.9477,2,1,3,-2,0.00129333
1038,40.6787,-73.996,2,13,9,4,0.000223333
1040,40.6705,-73.9821,2,15,18,-3,0.00112333
1043,40.6667,-73.9397,2,14,15,-1,0.000231667
1051,40.6737,-73.9632,2,4,19,-15,0.000811444
1052,40.719,-73.9585,2,11,12,-1,0.000185
1056,40.6712,-73.9748,2,3,15,-12,0.000651111
1059,40.6524,-73.9562,2,9,17,-8,0.000847917
1062,40.6662,-73.9316,2,5,14,-9,0.000747352
1064,40.6577,-73.9398,2,17,19,-2,0.000123417
1065,40.7219,-74.0077,2,51,5,46,0.000842717
1066,40.7131,-73.9985,2,40,44,-4,0.000854167
1068,40.6798,-73.9847,2,27,16,11,0.00108773
1073,40.7403,-73.9841,2,3,4,-1,0.000365
1075,40.658,-73.9605,2,7,21,-14,0.00100595
1077,40.7382,-73.9774,2,11,21,-10,0.000757333
1080,40.6604,-73.9568,2,11,20,-9,0.000795907
1083,40.7303,-73.9805,2,17,23,-6,0.000333889
1084,40.666,-73.9284,2,13,17,-4,0.000752458
1091,40.7153,-74.0166,2,10,4,6,0.000653333
1092,40.65,-73.933,2,13,14,-1,7.25e-05
1095,40.7105,-73.9609,2,8,34,-26,0.000919423
1098,40.7059,-74.0132,2,55,3,52,0.00117478
1101,40.678,-73.9624,2,5,7,-2,0.000403333
1102,40.6573,-73.9742,2,19,31,-12,0.000756667
1106,40.649,-73.9767,2,15,2,13,0.000850256
1107,40.6751,-73.9752,2,7,4,3,0.000440556
1109,40.7234,-73.9886,2,55,28,27,0.000557037
1110,40.6741,-73.9787,2,13,18,-5,0.00121633
1111,40.7107,-73.9597,2,30,32,-2,0.000164167
1114,40.7108,-73.994,2,40,36,4,0.000908333
1115,40.6922,-73.9843,2,14,18,-4,9.20833e-05
1116,40.7191,-74.0067,2,23,18,5,0.000299
1117,40.766,-73.9874,2,2,14,-12,0.00177389
1122,40.6714,-74.0013,2,23,2,21,0.00095127
1124,40.6999,-73.9897,2,3,4,-1,0.0002905
1125,40.6557,-74.0067,2,28,7,21,0.000934603
1132,40.6886,-73.9852,2,16,9,7,0.000504048
1133,40.7088,-73.951,2,14,15,-1,1e-05
1137,40.6451,-73.9797,2,2,9,-7,0.000506952
1139,40.7223,-73.9915,2,37,36,1,8.83333e-05
1140,40.7141,-73.9929,2,24,28,-4,0.000582083
1141,40.7563,-73.9642,2,6,32,-26,0.0011066
1142,40.7099,-73.9916,2,34,25,9,0.00195741
1144,40.6716,-73.9338,2,1,15,-14,0.00097194
1148,40.6861,-73.9263,2,4,14,-10,0.000883167
1149,40.6802,-73.9843,2,25,3,22,0.00108894
1153,40.744,-73.9914,2,10,25,-15,0.000540222
1157,40.715,-74.0125,2,16,5,11,2.30303e-05
1164,40.6822,-73.954,2,1,17,-16,0.00100177
1165,40.7619,-73.9772,2,0,5,-5,0.002067
1166,40.7071,-73.958,2,9,28,-19,0.000649061
1169,40.749,-73.9885,2,10,73,-63,0.00118431
1170,40.6768,-73.9833,2,23,11,12,0.000370847
1171,40.7129,-74.0102,2,8,18,-10,0.000477333
1172,40.6397,-74.009,2,8,23,-15,0.000590078
1175,40.6651,-73.9764,2,2,21,-19,0.00118465
1178,40.703,-73.9847,2,42,9,33,0.000788939
1179,40.6705,-73.9854,2,24,25,-1,0.000221667
1180,40.6663,-73.989,2,11,6,5,0.000665667
1182,40.7526,-73.975,2,1,10,-9,0.00250685
1183,40.6662,-73.982,2,0,8,-8,0.00301354
1191,40.7149,-74.0023,2,64,3,61,0.000888087
1197,40.6812,-74.0086,2,14,14,0,0
1203,40.6805,-73.9647,2,9,22,-13,0.000977564
1205,40.7193,-73.9818,2,9,11,-2,0.000481667
1208,40.6954,-73.9934,2,10,21,-11,0.000603788
1209,40.7444,-73.983,2,8,42,-34,0.000933333
1211,40.675,-73.9711,2,0,10,-10,0.0023885
1214,40.6883,-73.9955,2,36,38,-2,8.75e-05
1215,40.68,-73.9385,2,10,20,-10,0.0005193
1222,40.7262,-73.9951,2,46,37,9,6.61111e-05
1228,40.6731,-73.9419,2,5,13,-8,0.00062375
1229,40.7177,-73.9488,2,28,35,-7,0.000807381
1230,40.7551,-73.975,2,0,6,-6,0.00294722
1231,40.7232,-73.9948,2,22,32,-10,0.000707667
1232,40.7403,-73.9607,2,11,22,-11,0.000806364
1233,40.7359,-74.0009,2,34,47,-13,0.000524231
1238,40.7375,-74.0056,2,28,41,-13,0.000995385
1239,40.7217,-74.0024,2,24,12,12,0.000525694
1240,40.6896,-73.983,2,22,6,16,0.00138177
1241,40.7297,-73.9807,2,30,72,-42,0.00134321
1244,40.6696,-73.9424,2,4,23,-19,0.00247096
1250,40.7551,-73.9866,2,2,12,-10,0.001403
1252,40.6709,-73.9222,2,1,17,-16,0.000950635
1255,40.6635,-73.991,2,23,22,1,0.00085
1257,40.7383,-73.9901,2,63,20,43,0.00123527
1259,40.6662,-73.9955,2,18,2,16,0.000803562
1260,40.7013,-73.9847,2,37,1,36,0.00078375
1262,40.6824,-73.9441,2,10,12,-2,0.000280833
1265,40.7169,-73.9632,2,37,11,26,0.000805833
1269,40.7004,-73.9955,2,19,32,-13,0.000600897
1270,40.6867,-73.9906,2,46,5,41,0.00100093
1271,40.6525,-74.0136,2,18,5,13,0.000729821
1273,40.6611,-73.9795,2,1,6,-5,0.00355233
1274,40.7564,-73.99,2,10,92,-82,0.000395528
1276,40.7037,-74.0117,2,19,3,16,0.00106635
1283,40.6705,-73.9888,2,27,23,4,0.00018375
1285,40.6424,-74.0133,2,1,26,-25,0.000634387
1286,40.7086,-74.0094,2,14,10,4,0.000158333
1289,40.6828,-73.9999,2,24,22,2,0.00143417
1290,40.7142,-73.9967,2,39,44,-5,0.000694667
1292,40.7365,-74.0062,2,16,23,-7,0.000988333
1295,40.6801,-73.9317,2,1,3,-2,0.00123417
1298,40.6862,-73.9965,2,24,20,4,0.00186125
1299,40.7127,-74.0046,2,6,15,-9,0.000370741
1301,40.6957,-73.9713,2,12,6,6,0.000291028
1307,40.6984,-73.9807,2,50,18,32,0.000570729
1308,40.6638,-73.984,2,0,12,-12,0.00102764
1309,40.6826,-73.938,2,4,15,-11,0.000605909
1314,40.7521,-73.9816,2,1,4,-3,0.00192778
1317,40.7601,-73.9946,2,42,77,-35,0.00031
1320,40.6655,-73.993,2,22,8,14,0.000939107
1322,40.7077,-73.9402,2,14,36,-22,0.00091803
1323,40.6943,-73.9923,2,0,21,-21,0.000907619
1329,40.6827,-73.9293,2,7,12,-5,0.000593667
1330,40.7066,-73.9683,2,0,37,-37,0.000988829
1332,40.6465,-74.0261,2,11,0,11,0.000615348
1333,40.7617,-73.9826,2,3,5,-2,0.0006175
1337,40.7122,-73.9795,2,28,30,-2,0.000518333
1339,40.6868,-73.9593,2,8,12,-4,0.00038625
1340,40.743,-73.9771,2,29,45,-16,0.000347083
1341,40.753,-73.9873,2,1,9,-8,0.00273917
1343,40.7172,-73.988,2,45,33,12,0.000478333
1347,40.6782,-74.017,2,16,13,3,0.000285167
1351,40.6953,-73.9524,2,12,16,-4,0.000433708
1353,40.6758,-74.0147,2,2,2,0,0
1356,40.7566,-73.9979,2,24,29,-5,0.000438
1359,40.7322,-74.0003,2,59,73,-14,0.000905
1362,40.7064,-74.0056,2,75,33,42,0.000737857
1364,40.6613,-73.9535,2,18,19,-1,0.000208333
1365,40.6789,-73.9414,2,7,14,-7,0.000594881
1367,40.7603,-73.9988,2,16,36,-20,0.000881667
1372,40.7147,-73.9666,2,35,41,-6,0.000425278
1378,40.686,-73.9715,2,7,22,-15,0.000823333
1383,40.7394,-73.9993,2,17,66,-49,0.000752061
1386,40.7532,-73.9703,2,6,57,-51,0.00086866
1387,40.6487,-73.9608,2,14,21,-7,0.000976143
1388,40.7576,-73.991,2,24,27,-3,0.000194444
1389,40.6571,-74.0087,2,41,1,40,0.000837875
1390,40.755,-73.9801,2,4,11,-7,0.000613333
1392,40.7553,-73.9832,2,7,7,0,0
1394,40.6705,-73.9582,2,0,6,-6,0.00243147
1396,40.6541,-74.0011,2,18,3,15,0.000756267
1409,40.6776,-73.9496,2,4,4,0,0
1410,40.7185,-73.9833,2,33,41,-8,0.000244167
1411,40.6947,-73.9343,2,11,18,-7,0.00056881
1413,40.7449,-73.9953,2,12,47,-35,0.000775714
1417,40.7583,-73.9707,2,2,4,-2,0.000564167
1418,40.717,-74.0092,2,34,37,-3,0.000202778
1421,40.6725,-74.0049,2,11,10,1,8.78333e-05
1423,40.6769,-73.9333,2,2,6,-4,0.000518708
1427,40.7288,-74.0086,2,72,17,55,0.00112845
1429,40.6897,-73.9753,2,10,7,3,0.000272222
1430,40.7112,-73.9968,2,29,29,0,0
1431,40.7084,-74.0049,2,29,55,-26,0.00136494
1439,40.7329,-74.0071,2,64,60,4,0.000245833
1440,40.7298,-73.9955,2,7,16,-9,0.000977222
1444,40.6728,-73.9835,2,12,27,-15,0.000805444
1447,40.7184,-73.9615,2,33,8,25,0.000721267
1448,40.677,-74.0065,2,17,16,1,0.0001465
1449,40.6859,-74.0024,2,15,14,1,8.66667e-05
1452,40.7393,-74.0081,2,19,44,-25,0.0011626
1453,40.7284,-73.9871,2,59,66,-7,0.000623333
1454,40.6722,-73.9609,2,5,10,-5,0.000327667
1455,40.6424,-74.0255,2,32,4,28,0.000611327
1456,40.7415,-73.9833,2,2,71,-69,0.000962705
1459,40.6752,-73.936,2,1,12,-11,0.000776727
1460,40.6838,-73.9763,2,43,17,26,0.000289487
1466,40.7497,-73.9952,2,24,62,-38,0.00111921
1468,40.6449,-74.0145,2,5,16,-11,0.000404712
1469,40.7507,-74.0018,2,26,41,-15,0.00105344
1471,40.695,-73.9283,2,9,23,-14,0.000988476
1472,40.7083,-74.0171,2,50,62,-12,9.86111e-05
1473,40.7221,-73.9891,2,42,19,23,0.000838116
1480,40.7294,-73.9777,2,26,30,-4,0.000449583
1484,40.7248,-73.9843,2,29,43,-14,0.000968095
1492,40.7434,-73.9596,2,6,20,-14,0.000947738
1496,40.7145,-74.0056,2,16,7,9,0.000578148
1498,40.6874,-73.9818,2,9,5,4,0.000879167
1503,40.7161,-73.9919,2,104,110,-6,0.000459167
1504,40.681,-73.971,2,17,13,4,0.000289583
1505,40.6605,-73.9626,2,17,7,10,0.000973
1511,40.6864,-73.9876,2,59,66,-7,0.00019319
1512,40.7014,-73.9877,2,45,7,38,0.000765789
1513,40.7552,-74.0006,2,1,11,-10,0.00134167
1514,40.7578,-73.9793,2,2,4,-2,0.000570833
1515,40.6438,-73.9774,2,14,19,-5,0.0007624
1516,40.7224,-74.0057,2,8,12,-4,0.00013625
1518,40.6918,-73.9788,2,26,26,0,0
1525,40.7251,-73.9993,2,31,12,19,0.000930702
1527,40.657,-73.9982,2,11,16,-5,0.000506967
1532,40.682,-73.9803,2,1,24,-23,0.00130551
1533,40.6832,-73.966,2,1,23,-22,0.00173811
1535,40.716,-73.9997,2,39,31,8,0.00116312
1536,40.6474,-74.0009,2,15,18,-3,0.000703889
1538,40.6849,-73.963,2,11,12,-1,0.00031
1542,40.6629,-73.9402,2,15,17,-2,0.000503333
1543,40.6737,-73.9856,2,34,34,0,0
1551,40.6688,-73.9664,2,0,28,-28,0.000831375
1552,40.7295,-73.9843,2,54,54,0,0
1553,40.7117,-73.9514,2,15,18,-3,0.000546667
1554,40.6924,-73.9863,2,5,20,-15,0.00156933
1555,40.7528,-73.9928,2,3,21,-18,0.000900278
1556,40.6517,-73.976,2,14,2,12,0.000855278
1558,40.7317,-73.9612,2,49,49,0,0
1560,40.7027,-73.9925,2,15,6,9,0.000572963
1561,40.7383,-73.9875,2,1,18,-17,0.00304275
1562,40.7031,-74.0132,2,20,3,17,0.000675686
1567,40.7243,-74.0047,2,42,10,32,0.000746562
1568,40.7433,-74.0068,2,27,10,17,0.00177627
1569,40.6842,-73.9692,2,35,70,-35,0.00116948
1570,40.7394,-73.9768,2,6,12,-6,0.000333333
1575,40.7295,-73.9908,2,74,18,56,0.000632292
1583,40.7223,-74.0106,2,32,3,29,0.000738563
1584,40.6448,-73.9613,2,14,14,0,0
1587,40.7538,-73.9994,2,2,5,-3,0.00154944
1590,40.6801,-73.9918,2,17,21,-4,0.000846667
1595,40.6514,-74.0072,2,19,16,3,0.000581222
1598,40.664,-73.9477,2,19,19,0,0
1605,40.6773,-74.0128,2,30,34,-4,0.000988333
1606,40.6526,-73.9726,2,27,28,-1,0.000526333
1607,40.7249,-74.0017,2,52,31,21,0.000552698
1609,40.65,-74.0051,2,19,20,-1,0.00012
1610,40.7223,-73.9767,2,32,35,-3,0.000655
1612,40.7292,-73.9981,2,35,47,-12,0.000579028
1613,40.7271,-73.9966,2,35,23,12,0.000185417
1615,40.7174,-73.9996,2,34,13,21,0.00070373
1616,40.7406,-73.9985,2,26,40,-14,0.000719405
1618,40.7187,-74.009,2,30,35,-5,0.000279
1619,40.7178,-73.9763,2,13,13,0,0
1621,40.7311,-74.0089,2,50,23,27,0.000877531
1622,40.6854,-73.983,2,11,12,-1,0.00025
1628,40.6918,-73.9737,2,18,19,-1,0.000145
1631,40.7352,-74.0003,2,15,52,-37,0.000899369
1633,40.6548,-73.9732,2,31,33,-2,0.000557917
1636,40.7271,-74.003,2,40,39,1,5.16667e-05
1637,40.7109,-73.9683,2,23,30,-7,0.000469524
1638,40.6864,-73.9938,2,19,20,-1,2.66667e-05
1639,40.6978,-73.9737,2,2,42,-40,0.00128887
1640,40.6497,-73.9678,2,13,18,-5,0.0005832
1641,40.6534,-73.9763,2,16,18,-2,0.00031425
1644,40.6651,-73.9482,2,3,17,-14,0.000791869
1645,40.7323,-73.9985,2,30,21,9,0.000612593
1646,40.739,-74.0026,2,51,43,8,0.000242708
1650,40.7112,-74.0002,2,25,21,4,0.000542917
1653,40.6727,-74.0088,2,10,0,10,0.000798167
1654,40.6556,-73.9597,2,9,19,-10,0.00066575
1655,40.6648,-73.9427,2,5,9,-4,0.000434583
1656,40.6933,-73.9689,2,22,23,-1,5.66667e-05
1667,40.7597,-73.9781,2,6,8,-2,0.0004475
1671,40.6851,-73.9538,2,7,14,-7,0.000332619
1672,40.6496,-73.9632,2,19,24,-5,0.0003214
1674,40.6448,-73.9385,2,14,21,-7,0.00581164
1675,40.723,-73.98,2,33,42,-9,0.000679074
1684,40.6719,-73.9936,2,10,5,5,0.000492333
1685,40.7199,-74.0086,2,38,18,20,1.01667e-05
1686,40.717,-73.9564,2,14,15,-1,9e-05
1688,40.75,-73.9691,2,6,7,-1,0.000125
1691,40.6985,-73.9838,2,51,48,3,0.00186722
1694,40.6474,-74.0188,2,23,2,21,0.00103052
1696,40.7319,-74.0088,2,52,54,-2,0.000654167
1697,40.6711,-73.9422,2,6,14,-8,0.000689167
1701,40.7017,-73.9437,2,11,18,-7,0.000539286
1702,40.7414,-73.9754,2,7,21,-14,0.00113238
1703,40.7194,-73.9915,2,17,26,-9,0.000555
1705,40.7517,-73.9875,2,1,26,-25,0.00146687
1707,40.6867,-73.939,2,11,13,-2,0.000188333
1708,40.7189,-73.9927,2,62,60,2,0.000325833
1710,40.6664,-73.9606,2,4,16,-12,0.000809444
1711,40.6685,-73.9282,2,8,15,-7,0.00108826
1720,40.7093,-74.0132,2,43,35,8,0.00190604
1721,40.674,-73.9277,2,8,16,-8,0.000541146
1724,40.7429,-73.952,2,1,4,-3,0.00234944
1729,40.7428,-74.0075,2,36,5,31,0.000970968
1730,40.6592,-74.0066,2,23,1,22,0.000832659
1734,40.6951,-73.9872,2,2,10,-8,0.00131708
1737,40.6527,-74.0024,2,28,2,26,0.0006055
1749,40.6549,-73.9622,2,17,21,-4,0.000286667
1754,40.7205,-73.9949,2,32,33,-1,5e-06
1755,40.6902,-73.992,2,4,4,0,0
1760,40.6697,-73.9503,2,2,13,-11,0.000634864
1762,40.6535,-74.009,2,24,16,8,0.000282146
1765,40.7038,-73.9907,2,20,24,-4,0.000419583
1773,40.7236,-73.9995,2,51,34,17,0.000333824
1776,40.6708,-73.9577,2,0,6,-6,0.00240861
1787,40.6764,-73.9987,2,26,28,-2,0.000280833
1788,40.6924,-73.9934,2,7,4,3,0.000759444
1789,40.6931,-73.9718,2,16,20,-4,0.000465833
1790,40.7133,-73.9901,2,31,34,-3,0.000453333
1793,40.7317,-74.0067,2,42,42,0,0
1794,40.6566,-73.9839,2,9,8,1,5.5e-05
1803,40.6487,-74.0065,2,4,18,-14,0.000905024
1805,40.7093,-73.9561,2,11,11,0,0
1810,40.7202,-73.99,2,29,36,-7,0.000615238
1812,40.6801,-73.9536,2,2,3,-1,0.000711167
1813,40.6773,-73.9828,2,22,16,6,0.000323889
1814,40.7546,-73.9659,2,12,22,-10,0.0011705
1815,40.6643,-73.9592,2,9,14,-5,0.000544433
1816,40.6481,-73.9724,2,24,26,-2,0.000222333
1822,40.735,-74.007,2,38,40,-2,0.000249167
1826,40.7246,-73.9957,2,25,19,6,0.000303056
1835,40.687,-73.9766,2,7,4,3,0.00107778
1843,40.6892,-73.9886,2,37,9,28,0.000798631
1844,40.673,-73.939,2,5,8,-3,0.000323333
1847,40.6784,-74.0001,2,13,19,-6,0.000683056
1848,40.6726,-73.9898,2,13,3,10,0.000807167
1851,40.7272,-73.9768,2,17,34,-17,0.000957745
1853,40.6681,-73.9838,2,4,5,-1,0.000141667
1858,40.7041,-73.9482,2,4,10,-6,0.000424028
1859,40.6687,-73.9799,2,3,3,0,0
1863,40.7428,-73.9847,2,0,4,-4,0.00235333
1864,40.6447,-73.9632,2,17,20,-3,0.000358167
1865,40.7111,-74.0094,2,5,34,-29,0.000744195
1866,40.6681,-73.9736,2,0,25,-25,0.000887667
1867,40.7304,-74.0021,2,33,57,-24,0.000824792
1872,40.696,-73.9901,2,26,6,20,0.0005825
1875,40.6761,-73.9217,2,3,15,-12,0.000545208
1876,40.7496,-73.9881,2,0,60,-60,0.00139919
1878,40.7285,-73.9818,2,47,61,-14,0.00101167
1880,40.6591,-73.9885,2,14,17,-3,0.000918333
1884,40.7439,-73.9797,2,10,44,-34,0.000871569
1886,40.7047,-74.0093,2,28,10,18,0.000233889
1889,40.685,-73.9862,2,7,17,-10,0.000509667
1891,40.6334,-74.0166,2,17,23,-6,0.00101464
1893,40.6791,-73.9718,2,3,5,-2,0.0003625
1899,40.7008,-73.9887,2,43,5,38,0.000610482
1903,40.6533,-73.9364,2,16,19,-3,0.000179556
1906,40.6769,-73.9361,2,4,10,-6,0.000400194
1914,40.7334,-74.0085,2,59,64,-5,0.000306667
1915,40.6386,-74.0101,2,10,16,-6,0.000412444
1916,40.6862,-73.9447,2,8,12,-4,0.000667917
1917,40.7161,-73.952,2,9,16,-7,0.00085
1918,40.7022,-73.9826,2,29,12,17,0.000647578
1920,40.6585,-73.9855,2,3,18,-15,0.00115609
1923,40.6747,-74.0076,2,29,26,3,0.000105889
1926,40.6985,-73.9972,2,18,15,3,0.0001205
1928,40.7362,-73.9847,2,9,29,-20,0.001223
1933,40.7497,-74.003,2,12,32,-20,0.000366
1934,40.7584,-73.9826,2,0,7,-7,0.00319095
1936,40.746,-73.9863,2,23,8,15,0.00114878
1937,40.7083,-73.9487,2,16,19,-3,0.000412222
1942,40.6806,-73.9948,2,32,7,25,0.000657267
1943,40.7274,-73.9814,2,89,94,-5,0.000490667
1944,40.71,-74.0165,2,40,38,2,0.000470833
1945,40.6749,-74.0105,2,18,20,-2,0.000266083
1946,40.6793,-73.9815,2,38,18,20,0.00126558
1947,40.6681,-73.9505,2,3,7,-4,0.000958333
1950,40.658,-73.9896,2,18,16,2,0.000195
1959,40.6767,-73.9444,2,5,9,-4,0.000116542
1963,40.6727,-73.9541,2,3,10,-7,0.000369286
1964,40.6685,-73.9933,2,21,21,0,0
1970,40.7432,-74.0037,2,48,34,14,0.000287738
1971,40.6764,-73.9275,2,4,12,-8,0.000427396
1973,40.6907,-73.9513,2,4,7,-3,0.000767222
1974,40.7202,-74.0103,2,14,7,7,0.000559524
1975,40.7225,-73.9592,2,20,21,-1,8.16667e-05
1978,40.762,-73.997,2,23,42,-19,8.50877e-05
1980,40.6552,-73.9564,2,7,13,-6,0.000465
1981,40.7051,-73.9708,2,12,1,11,0.000748424
1982,40.6979,-73.9766,2,14,9,5,0.000664333
1983,40.6491,-74.0124,2,20,11,9,0.000455611
1988,40.6893,-73.9573,2,19,20,-1,0.000215
1993,40.6663,-73.9855,2,21,20,1,0.000291667
1996,40.7523,-73.9877,2,1,6,-5,0.00175933
1997,40.6686,-73.9904,2,20,23,-3,0.00111911
1999,40.6924,-73.9371,2,12,14,-2,0.000473333
2006,40.7003,-73.9916,2,14,30,-16,0.000837917
2007,40.7573,-73.9742,2,0,2,-2,0.0020275
2009,40.7284,-73.9997,2,43,57,-14,0.00084881
2010,40.7261,-73.9562,2,21,25,-4,0.000254167
2012,40.679,-73.9786,2,17,23,-6,0.0008175
2013,40.6778,-74.0095,2,15,9,6,0.000498972
2014,40.6452,-73.9707,2,19,19,0,0
2015,40.6977,-73.9848,2,10,15,-5,0.000712
2016,40.6507,-73.9777,2,16,19,-3,0.000732667
2017,40.7213,-74.0101,2,2,4,-2,0.000858333
2019,40.7175,-73.9585,2,8,12,-4,0.0003
2021,40.6656,-73.9371,2,10,16,-6,0.00073
2027,40.6732,-73.9569,2,3,11,-8,0.000926875
2028,40.7473,-73.9545,2,37,40,-3,0.00111944
2032,40.6883,-73.9509,2,3,15,-12,0.000938333
2034,40.7537,-73.9587,2,0,18,-18,0.000902565
2036,40.7501,-73.9984,2,28,37,-9,0.000895556
2037,40.7613,-73.9798,2,4,16,-12,0.000462361
2039,40.7058,-73.9633,2,10,15,-5,0.000561333
2043,40.742,-74.0083,2,50,14,36,0.000766944
2045,40.7328,-73.9958,2,41,51,-10,0.000802
2047,40.7122,-74.0105,2,11,60,-49,0.000590272
2051,40.6901,-73.9788,2,42,5,37,0.000869279
2054,40.6713,-73.9283,2,1,19,-18,0.000934694
2055,40.7125,-74.0111,2,15,96,-81,0.000886337
2057,40.7034,-74.0079,2,62,46,16,0.000151979
2058,40.6451,-73.9488,2,23,2,21,0.000984063
2060,40.648,-73.9556,2,15,17,-2,0.000429417
2070,40.7208,-73.9484,2,12,15,-3,0.000646667
2073,40.7019,-74.0109,2,22,1,21,0.000823651
2076,40.6701,-73.9254,2,12,18,-6,0.00133267
2077,40.683,-74.0035,2,17,32,-15,0.000306556
2078,40.7353,-73.998,2,50,66,-16,0.000255938
2083,40.6894,-73.9689,2,8,11,-3,0.000346667
2084,40.6662,-73.9925,2,30,27,3,-0.0585378
2085,40.7068,-73.9544,2,6,48,-42,0.000848929
2087,40.6517,-73.9812,2,16,20,-4,0.000385458
2091,40.7143,-73.9899,2,0,24,-24,0.00182076
2093,40.7314,-73.9949,2,23,13,10,0.000437983
2098,40.6553,-74.0031,2,16,11,5,0.0005254
2102,40.7277,-74.0113,2,10,3,7,0.00133071
4,40.7728,-73.9558,3,9,21,-12,0.000951389
6,40.8257,-73.9273,3,10,13,-3,0.000288778
9,40.814,-73.9119,3,7,8,-1,9.95e-05
10,40.8326,-73.9251,3,11,17,-6,0.000278083
12,40.8823,-73.9081,3,15,20,-5,0.0082607
19,40.7896,-73.9776,3,20,36,-16,0.000934479
20,40.7934,-73.9433,3,18,21,-3,0.000453667
26,40.8182,-73.9253,3,6,7,-1,0.000161667
27,40.8353,-73.9154,3,0,15,-15,0.00132957
28,40.8674,-73.9294,3,7,12,-5,0.0002454
30,40.7893,-73.9396,3,18,20,-2,0.000498333
33,40.8168,-73.9173,3,10,2,8,0.00090875
34,40.8681,-73.8815,3,24,20,4,0.000185667
36,40.8583,-73.9063,3,3,14,-11,0.000733636
39,40.8367,-73.8879,3,5,10,-5,0.000377733
42,40.8617,-73.8986,3,1,3,-2,0.00115692
44,40.8656,-73.8881,3,15,11,4,0.000382958
45,40.7859,-73.9548,3,21,3,18,0.00055787
50,40.8444,-73.878,3,15,9,6,0.000619583
56,40.8421,-73.9261,3,2,13,-11,0.000204561
58,40.7946,-73.9363,3,22,22,0,0
60,40.8382,-73.9361,3,3,3,0,0
61,40.7974,-73.9704,3,29,30,-1,0.000138333
63,40.81,-73.9552,3,23,25,-2,0.000261333
64,40.8303,-73.9234,3,2,13,-11,0.00058447
67,40.8232,-73.9559,3,7,27,-20,0.000701058
70,40.7834,-73.9809,3,5,34,-29,0.000969138
73,40.7835,-73.9553,3,22,30,-8,0.00111854
75,40.8072,-73.9418,3,20,18,2,0.000199417
77,40.8419,-73.8855,3,17,17,0,0
79,40.758,-73.966,3,6,13,-7,0.000568571
80,40.8145,-73.925,3,13,12,1,0.000106333
83,40.8305,-73.9046,3,4,7,-3,0.0001395
84,40.7921,-73.9739,3,10,3,7,0.00106476
86,40.8313,-73.9467,3,1,13,-12,0.00112044
92,40.7683,-73.9886,3,22,29,-7,0.00033119
93,40.8714,-73.8884,3,6,10,-4,0.00036425
95,40.8188,-73.8882,3,10,10,0,0
98,40.8276,-73.8867,3,12,2,10,0.000825833
99,40.8552,-73.9128,3,1,9,-8,0.000650271
102,40.7746,-73.9237,3,5,10,-5,0.000310433
103,40.8431,-73.8915,3,10,15,-5,0.000624367
109,40.8447,-73.8851,3,5,19,-14,0.000728143
110,40.8004,-73.911,3,13,6,7,0.000390976
111,40.8305,-73.8947,3,14,15,-1,0.000335333
116,40.8503,-73.893,3,19,8,11,0.00103755
125,40.7817,-73.9459,3,25,32,-7,0.000486429
126,40.8051,-73.9189,3,20,13,7,0.000752929
129,40.8712,-73.8992,3,2,16,-14,0.000839071
132,40.8405,-73.9115,3,5,4,1,5.08333e-05
133,40.7775,-73.9225,3,12,19,-7,0.000592619
140,40.8585,-73.9027,3,8,22,-14,0.00049531
145,40.8316,-73.9149,3,19,18,1,0.0004755
146,40.8279,-73.9271,3,9,5,4,0.0005875
149,40.8599,-73.8914,3,27,7,20,0.000922267
151,40.8681,-73.8841,3,17,16,1,0.000254833
152,40.7872,-73.9813,3,21,60,-39,0.000886197
156,40.8666,-73.8979,3,12,3,9,0.000675407
157,40.7786,-73.9775,3,3,25,-22,0.00122303
160,40.877,-73.8894,3,3,4,-1,6.66667e-06
161,40.7687,-73.8907,3,18,21,-3,0.000566611
162,40.8422,-73.8985,3,17,22,-5,0.0002054
167,40.8434,-73.8825,3,4,18,-14,0.00102369
168,40.8232,-73.9233,3,6,4,2,0.0001535
173,40.8143,-73.959,3,26,35,-9,0.000496889
176,40.8532,-73.9272,3,5,18,-13,0.000682949
178,40.8559,-73.9005,3,2,23,-21,0.000901921
179,40.8142,-73.9039,3,15,17,-2,0.00028175
184,40.8392,-73.899,3,2,4,-2,0.000705833
188,40.8496,-73.9161,3,3,8,-5,0.000521567
189,40.7802,-73.9773,3,9,43,-34,0.00100451
196,40.7768,-73.9346,3,19,20,-1,0.000567
197,40.8781,-73.8919,3,1,5,-4,0.000425
205,40.7825,-73.9145,3,13,19,-6,0.000994444
208,40.7882,-73.9704,3,11,37,-26,0.000711346
211,40.768,-73.9685,3,2,14,-12,0.001405
213,40.7603,-73.9222,3,1,15,-14,0.00182131
219,40.8393,-73.8864,3,14,18,-4,0.000733
224,40.8359,-73.8931,3,0,13,-13,0.000875346
226,40.8074,-73.9192,3,16,5,11,0.000679848
227,40.8395,-73.913,3,0,11,-11,0.00136442
229,40.834,-73.9451,3,8,24,-16,0.000663677
236,40.7728,-73.9499,3,31,39,-8,0.000854583
242,40.8617,-73.8911,3,24,4,20,0.00102858
246,40.8363,-73.8843,3,8,4,4,0.000645417
248,40.8198,-73.9124,3,10,9,1,6.66667e-06
249,40.7975,-73.9312,3,13,17,-4,0.0009515
252,40.8484,-73.9184,3,3,20,-17,0.000674225
253,40.8109,-73.9273,3,10,8,2,0.000529833
254,40.8207,-73.9451,3,8,12,-4,0.000210417
257,40.8211,-73.936,3,6,5,1,0.000232333
259,40.8326,-73.8853,3,6,15,-9,0.000882148
262,40.7724,-73.99,3,19,30,-11,0.000874697
263,40.7607,-73.911,3,8,19,-11,0.00103786
265,40.7647,-73.924,3,0,14,-14,0.00178655
270,40.7648,-73.9704,3,0,18,-18,0.00190648
271,40.7806,-73.9522,3,14,32,-18,0.000528704
272,40.8547,-73.9015,3,2,19,-17,0.000843137
275,40.8345,-73.9284,3,8,7,1,7.66667e-05
278,40.8549,-73.9167,3,2,12,-10,0.000355283
281,40.846,-73.8843,3,6,17,-11,0.000870545
284,40.8358,-73.9434,3,1,18,-17,0.001056
286,40.8477,-73.9221,3,1,16,-15,0.00128
291,40.7659,-73.9308,3,11,16,-5,0.000453667
293,40.8197,-73.9518,3,5,17,-12,0.000906389
295,40.8433,-73.9049,3,4,11,-7,0.000751952
297,40.8075,-73.9271,3,7,10,-3,0.000295833
298,40.7589,-73.9623,3,8,12,-4,0.000307917
303,40.8163,-73.8964,3,18,9,9,0.000688704
304,40.8056,-73.9147,3,11,21,-10,0.0009862
306,40.8127,-73.9237,3,11,14,-3,0.000302722
312,40.8052,-73.9547,3,31,33,-2,0.000401667
313,40.7728,-73.9274,3,4,19,-15,0.000705444
314,40.8492,-73.9302,3,5,10,-5,0.000578233
316,40.8307,-73.9413,3,0,19,-19,0.00163376
318,40.8089,-73.9108,3,2,4,-2,0.00134158
319,40.7829,-73.9308,3,2,7,-5,0.000411
321,40.8474,-73.9312,3,8,11,-3,0.000185278
333,40.8483,-73.9097,3,13,20,-7,0.00114188
334,40.8224,-73.9269,3,12,2,10,0.00101067
339,40.7699,-73.9606,3,2,31,-29,0.000957989
346,40.8463,-73.9093,3,3,18,-15,0.000978989
347,40.8745,-73.9047,3,18,19,-1,6.38333e-05
350,40.8313,-73.9174,3,8,16,-8,0.00136987
353,40.8034,-73.9198,3,12,10,2,0.000309417
356,40.7775,-73.9889,3,43,73,-30,0.000227167
364,40.8272,-73.9177,3,12,15,-3,0.000304444
365,40.8455,-73.9143,3,15,4,11,0.000728
368,40.7743,-73.9083,3,10,23,-13,0.000860846
369,40.8302,-73.9287,3,12,16,-4,0.000680292
371,40.8567,-73.9027,3,7,10,-3,0.000232333
373,40.8267,-73.8887,3,8,5,3,0.000194
374,40.7611,-73.9306,3,8,22,-14,0.00119607
375,40.769,-73.9548,3,21,56,-35,0.000517619
378,40.7848,-73.9699,3,21,29,-8,0.000556667
380,40.7731,-73.9586,3,0,5,-5,0.00275633
382,40.7656,-73.9137,3,5,18,-13,0.000990769
385,40.8015,-73.9443,3,15,24,-9,0.00110074
386,40.7814,-73.956,3,26,35,-9,0.00102519
390,40.8553,-73.9379,3,3,18,-15,0.000608667
402,40.7371,-73.9008,3,19,18,1,-0.145659
404,40.8629,-73.9032,3,0,15,-15,0.000853489
405,40.8621,-73.9297,3,4,15,-11,0.000560303
408,40.8025,-73.9532,3,19,8,11,0.00111742
409,40.8322,-73.8897,3,5,18,-13,0.00094991
420,40.8592,-73.9339,3,4,23,-19,0.000698816
423,40.8113,-73.9077,3,7,7,0,0
425,40.8341,-73.8895,3,1,16,-15,0.00112741
431,40.7714,-73.9246,3,20,23,-3,0.000383889
435,40.8547,-73.8902,3,12,10,2,0.0001825
437,40.7758,-73.9762,3,4,43,-39,0.000823291
438,40.8738,-73.8866,3,9,4,5,0.000432033
442,40.792,-73.9681,3,18,24,-6,0.000431667
447,40.8604,-73.9093,3,1,16,-15,0.000997856
449,40.82,-73.8973,3,13,16,-3,0.000170833
455,40.8427,-73.9085,3,13,5,8,0.000486021
460,40.8126,-73.9492,3,20,10,10,0.0003654
463,40.8626,-73.9227,3,13,14,-1,8.25e-05
468,40.8661,-73.9226,3,13,16,-3,0.000308056
475,40.8343,-73.9176,3,3,14,-11,0.000471818
480,40.7998,-73.9621,3,2,9,-7,0.000856667
482,40.7781,-73.9607,3,9,31,-22,0.00075197
483,40.8781,-73.908,3,18,18,0,0
486,40.8341,-73.9224,3,13,15,-2,0.00021675
489,40.8166,-73.8882,3,1,11,-10,0.0007474
491,40.832,-73.9196,3,1,15,-14,0.000916857
493,40.829,-73.9113,3,16,17,-1,1.1e-05
495,40.8008,-73.9664,3,16,29,-13,0.000919744
496,40.8741,-73.8834,3,14,15,-1,4.15e-05
499,40.7701,-73.9121,3,10,12,-2,0.0004125
512,40.763,-73.9721,3,0,3,-3,0.000908889
515,40.8384,-73.9058,3,15,18,-3,0.000936944
524,40.8523,-73.9379,3,2,24,-22,0.000871288
534,40.8423,-73.8941,3,2,16,-14,0.000655024
538,40.8731,-73.9184,3,15,19,-4,0.000601583
543,40.8161,-73.9081,3,8,14,-6,0.000737417
544,40.7725,-73.9468,3,19,29,-10,0.000789667
545,40.8086,-73.9161,3,8,17,-9,0.000662815
548,40.8272,-73.8937,3,8,4,4,0.000423708
551,40.8536,-73.9087,3,23,7,16,0.000858531
560,40.795,-73.9645,3,22,30,-8,0.000746042
562,40.8431,-73.8899,3,1,12,-11,0.00134377
568,40.8084,-73.9452,3,23,8,15,0.000817111
569,40.8482,-73.9161,3,5,15,-10,0.000711183
571,40.8396,-73.9003,3,8,2,6,0.00115722
576,40.87,-73.8856,3,17,15,2,0.000383417
580,40.8383,-73.9126,3,2,21,-19,0.000707307
585,40.8082,-73.9641,3,8,26,-18,0.000630278
586,40.8538,-73.9208,3,10,14,-4,0.000478167
587,40.8076,-73.9392,3,7,7,0,0
588,40.8541,-73.8993,3,7,18,-11,0.000947742
590,40.8122,-73.9378,3,10,14,-4,0.000268208
592,40.8455,-73.9172,3,11,2,9,0.000703389
607,40.7614,-73.9411,3,1,7,-6,0.000665833
611,40.8803,-73.8861,3,6,2,4,0.00132192
613,40.8339,-73.9211,3,9,25,-16,0.0006885
615,40.8172,-73.9388,3,18,15,3,0.000402778
616,40.8228,-73.9374,3,8,17,-9,0.000504556
619,40.8747,-73.911,3,10,3,7,0.000572786
623,40.8213,-73.9479,3,6,18,-12,0.000554306
630,40.8176,-73.9572,3,13,8,5,0.000525
639,40.8009,-73.9139,3,16,8,8,0.000392417
641,40.8251,-73.9416,3,8,16,-8,0.000371563
645,40.8239,-73.9087,3,23,20,3,0.000223833
647,40.7574,-73.9451,3,10,14,-4,0.000608958
654,40.8178,-73.9052,3,6,20,-14,0.000745524
658,40.825,-73.8917,3,8,8,0,0
660,40.7767,-73.9066,3,3,19,-16,0.000780104
668,40.8296,-73.9215,3,1,5,-4,0.000921542
671,40.8231,-73.9419,3,8,9,-1,8.61667e-05
674,40.8446,-73.8799,3,8,17,-9,0.000582778
675,40.7705,-73.988,3,17,92,-75,0.000779133
676,40.8391,-73.9414,3,0,9,-9,0.00128198
681,40.784,-73.9169,3,18,19,-1,0.000701667
682,40.8601,-73.9285,3,19,17,2,9.875e-05
686,40.8097,-73.9531,3,24,5,19,0.0010436
690,40.7655,-73.9181,3,10,25,-15,0.000932333
694,40.8291,-73.9504,3,3,19,-16,0.000798146
696,40.8619,-73.8948,3,0,4,-4,0.00124283
698,40.8733,-73.9066,3,17,5,12,0.000875764
699,40.8671,-73.9173,3,14,2,12,0.000803222
701,40.7631,-73.9653,3,1,19,-18,0.00121926
702,40.8631,-73.927,3,15,18,-3,0.000437667
711,40.7576,-73.9391,3,5,15,-10,0.000621167
716,40.8164,-73.9543,3,6,12,-6,0.000606667
718,40.8086,-73.9596,3,0,6,-6,0.00224639
720,40.7738,-73.9622,3,3,9,-6,0.00111278
721,40.8007,-73.9349,3,17,5,12,0.0005995
722,40.7969,-73.9643,3,14,28,-14,0.00111036
726,40.8365,-73.9183,3,12,17,-5,0.000831333
727,40.7632,-73.9208,3,5,18,-13,0.0011391
729,40.7647,-73.9622,3,4,27,-23,0.000917826
733,40.84,-73.8806,3,21,11,10,0.000779617
735,40.7923,-73.9525,3,17,1,16,0.000912917
737,40.7709,-73.8899,3,13,16,-3,0.000295389
739,40.7729,-73.9161,3,28,38,-10,0.0004099
741,40.8394,-73.937,3,0,3,-3,0.00292128
744,40.8027,-73.963,3,18,34,-16,0.000955104
745,40.839,-73.9109,3,12,15,-3,0.000195389
748,40.827,-73.9497,3,2,26,-24,0.00122843
749,40.8021,-73.9682,3,19,25,-6,0.00056
750,40.7641,-73.981,3,0,6,-6,0.00239778
753,40.8371,-73.9022,3,22,17,5,0.00131773
759,40.824,-73.9547,3,1,19,-18,0.000991574
761,40.8318,-73.8969,3,4,12,-8,0.000412354
764,40.804,-73.9459,3,12,19,-7,0.000429286
765,40.8501,-73.9108,3,27,16,11,0.000419091
766,40.799,-73.9665,3,13,33,-20,0.000779167
767,40.8253,-73.8877,3,12,11,1,0.0001245
770,40.8842,-73.8979,3,14,8,6,0.000376806
774,40.8823,-73.887,3,1,3,-2,2.35e-05
775,40.8714,-73.9143,3,12,13,-1,4.21667e-05
776,40.7747,-73.9847,3,1,12,-11,0.00163
784,40.8123,-73.9204,3,8,2,6,0.000780778
786,40.846,-73.9196,3,7,19,-12,0.000814361
788,40.7786,-73.9577,3,11,26,-15,0.000587222
790,40.857,-73.8982,3,1,19,-18,0.00079512
791,40.8029,-73.9379,3,11,6,5,0.000487333
794,40.8465,-73.9039,3,1,17,-16,0.00103754
798,40.7806,-73.9856,3,23,34,-11,0.000739697
800,40.814,-73.8855,3,9,9,0,0
807,40.8126,-73.9292,3,18,4,14,0.000934762
809,40.8579,-73.8815,3,3,3,0,0
810,40.8462,-73.8932,3,3,2,1,0.000115
812,40.8843,-73.8878,3,1,17,-16,0.000439219
815,40.8095,-73.9478,3,20,4,16,0.00102604
820,40.8247,-73.9519,3,2,19,-17,0.00122716
822,40.7955,-73.9416,3,17,17,0,0
823,40.8222,-73.9289,3,17,2,15,0.00154321
830,40.819,-73.902,3,3,14,-11,0.000484545
831,40.8431,-73.9002,3,17,10,7,0.000641905
835,40.8679,-73.9197,3,22,4,18,0.000862139
836,40.8321,-73.9424,3,2,23,-21,0.000923484
840,40.8692,-73.9012,3,0,18,-18,0.000932176
842,40.8207,-73.9118,3,13,18,-5,0.0004749
843,40.7654,-73.9399,3,9,24,-15,0.00114857
845,40.8629,-73.9011,3,2,9,-7,0.0011666
849,40.8044,-73.9515,3,19,21,-2,0.000193333
850,40.855,-73.9108,3,4,6,-2,0.000189083
852,40.8531,-73.8895,3,14,19,-5,0.0005467
853,40.7775,-73.9829,3,5,27,-22,0.00038447
855,40.8852,-73.9008,3,23,3,20,0.000920933
860,40.8508,-73.8894,3,15,19,-4,0.000527583
861,40.7639,-73.9477,3,25,30,-5,0.000721667
863,40.8822,-73.8914,3,5,22,-17,0.0014279
867,40.8724,-73.9128,3,10,2,8,0.000911
872,40.8252,-73.9473,3,4,18,-14,0.000939762
873,40.8046,-73.9397,3,26,4,22,0.000835
877,40.765,-73.9582,3,20,32,-12,3.79722e-05
879,40.858,-73.9322,3,14,21,-7,0.000726405
885,40.7682,-73.9323,3,15,16,-1,1.66667e-06
887,40.7814,-73.9183,3,14,23,-9,0.000650926
888,40.8269,-73.9414,3,1,17,-16,0.000996458
891,40.8615,-73.881,3,2,1,1,0.000464333
894,40.8657,-73.9086,3,3,18,-15,0.000884822
896,40.8345,-73.9399,3,0,20,-20,0.00105787
897,40.8206,-73.8883,3,6,15,-9,0.000534611
904,40.8321,-73.9274,3,2,14,-12,0.000695111
908,40.7697,-73.906,3,7,20,-13,0.00098109
916,40.7887,-73.9668,3,9,12,-3,0.000225556
918,40.8452,-73.9405,3,4,19,-15,0.00111919
921,40.7572,-73.9327,3,7,20,-13,0.00060641
926,40.8475,-73.8946,3,9,3,6,0.000602583
927,40.8714,-73.8929,3,3,16,-13,0.000731474
929,40.7823,-73.9599,3,27,4,23,0.000962391
931,40.844,-73.921,3,3,16,-13,0.000592449
932,40.7828,-73.9714,3,5,41,-36,0.00104019
933,40.8465,-73.8962,3,9,2,7,0.000926071
936,40.8695,-73.8915,3,1,15,-14,0.00086881
945,40.7671,-73.917,3,10,22,-12,0.00111458
953,40.8332,-73.8966,3,3,11,-8,0.000670146
956,40.8282,-73.9037,3,3,16,-13,0.000745949
962,40.7781,-73.9084,3,1,13,-12,0.000740444
963,40.8234,-73.9247,3,7,5,2,1.33333e-05
965,40.8327,-73.9052,3,6,11,-5,0.000505333
966,40.8182,-73.9553,3,11,7,4,0.000287792
972,40.8155,-73.9359,3,9,9,0,0
976,40.795,-73.9333,3,10,2,8,0.000991667
978,40.8237,-73.9194,3,10,26,-16,0.00106577
980,40.8131,-73.9092,3,4,18,-14,0.00080131
983,40.8372,-73.9466,3,2,24,-22,0.00083522
986,40.8145,-73.9362,3,12,15,-3,0.000262944
990,40.878,-73.8848,3,11,2,9,0.00111276
994,40.771,-73.9536,3,21,44,-23,0.00084587
995,40.8199,-73.9084,3,5,17,-12,0.000768056
996,40.867,-73.8858,3,20,11,9,0.000329259
1002,40.7975,-73.9489,3,21,19,2,0.000395833
1003,40.7954,-73.9441,3,8,23,-15,0.000804333
1005,40.8069,-73.9118,3,4,13,-9,0.000719389
1007,40.7786,-73.919,3,8,17,-9,0.000857315
1009,40.8561,-73.8863,3,11,19,-8,0.000797333
1011,40.8196,-73.9161,3,15,14,1,1.65e-05
1015,40.834,-73.9089,3,19,17,2,0.00228633
1017,40.8705,-73.8819,3,16,19,-3,0.000727167
1027,40.7925,-73.9642,3,32,24,8,0.00019625
1028,40.8539,-73.8866,3,19,20,-1,0.000530833
1029,40.8005,-73.924,3,13,2,11,0.000764515
1032,40.803,-73.943,3,17,22,-5,0.000471
1033,40.8271,-73.9459,3,4,19,-15,0.00108604
1041,40.8441,-73.9173,3,13,1,12,0.000705528
1042,40.8523,-73.9313,3,7,24,-17,0.000981206
1047,40.7712,-73.9641,3,1,12,-11,0.00122182
1048,40.8512,-73.9147,3,8,19,-11,0.000889939
1049,40.8239,-73.8974,3,11,2,9,0.000849648
1050,40.8119,-73.9042,3,21,9,12,0.000788569
1053,40.8376,-73.9105,3,3,15,-12,0.000540806
1054,40.7727,-73.9061,3,6,18,-12,0.00077475
1055,40.7797,-73.9809,3,23,40,-17,0.000561078
1057,40.82,-73.9591,3,13,1,12,0.000928486
1058,40.8225,-73.9018,3,2,5,-3,0.000630556
1060,40.8393,-73.9224,3,15,12,3,0.000477222
1061,40.7667,-73.9791,3,4,11,-7,0.0014319
1069,40.7682,-73.8963,3,14,17,-3,0.000577167
1070,40.886,-73.9023,3,14,13,1,0.000108167
1071,40.8391,-73.926,3,10,17,-7,0.000637476
1072,40.7762,-73.9153,3,13,19,-6,0.00127783
1076,40.7704,-73.9286,3,9,12,-3,0.000905556
1078,40.8084,-73.9236,3,11,18,-7,0.000917381
1081,40.8685,-73.8885,3,15,22,-7,0.000824524
1086,40.824,-73.9109,3,7,20,-13,0.000888218
1087,40.7982,-73.9606,3,28,45,-17,0.000847647
1088,40.7692,-73.9355,3,15,20,-5,0.000922
1089,40.8123,-73.9462,3,10,19,-9,0.000722222
1094,40.8405,-73.9179,3,24,4,20,0.00117525
1096,40.7975,-73.9345,3,17,14,3,0.000722222
1097,40.7564,-73.9365,3,3,18,-15,0.000952
1099,40.8649,-73.9024,3,1,18,-17,0.000993657
1100,40.8616,-73.9122,3,18,19,-1,0.000108167
1103,40.8563,-73.9073,3,0,3,-3,0.00147378
1104,40.8026,-73.9174,3,1,15,-14,0.000715333
1105,40.832,-73.8927,3,4,17,-13,0.000746
1112,40.8301,-73.8863,3,13,1,12,0.00134869
1113,40.8299,-73.9076,3,8,17,-9,0.000991667
1118,40.8039,-73.9559,3,30,25,5,0.00190667
1119,40.8751,-73.9013,3,13,18,-5,0.000750533
1121,40.8317,-73.9224,3,5,19,-14,0.00108433
1123,40.8711,-73.9115,3,16,4,12,0.000545708
1130,40.8755,-73.8864,3,14,17,-3,0.000617778
1135,40.8257,-73.9156,3,10,9,1,0.000173333
1136,40.8073,-73.9081,3,6,3,3,0.0001405
1138,40.8209,-73.9275,3,23,4,19,0.00089
1143,40.8322,-73.9497,3,5,16,-11,0.000577242
1145,40.8505,-73.9013,3,10,19,-9,0.00122778
1146,40.8392,-73.8886,3,2,16,-14,0.0010096
1147,40.8787,-73.8986,3,5,18,-13,0.000627692
1150,40.8572,-73.8909,3,11,15,-4,0.000511708
1156,40.8677,-73.8929,3,2,19,-17,0.000920961
1158,40.8212,-73.9173,3,2,18,-16,0.000796906
1160,40.85,-73.9128,3,2,18,-16,0.000953302
1162,40.7596,-73.9321,3,9,22,-13,0.000918192
1174,40.8501,-73.8982,3,18,21,-3,0.000292667
1177,40.8117,-73.917,3,11,17,-6,0.000787694
1185,40.8144,-73.9154,3,5,7,-2,0.00014775
1186,40.8136,-73.9393,3,16,4,12,0.00108125
1187,40.7849,-73.9505,3,18,25,-7,0.000600952
1188,40.8556,-73.8962,3,19,16,3,0.000422389
1192,40.7841,-73.9836,3,9,74,-65,0.000471564
1194,40.866,-73.9043,3,4,20,-16,0.000939396
1196,40.774,-73.9309,3,13,31,-18,0.00123296
1199,40.8654,-73.9279,3,16,9,7,0.00031769
1201,40.8013,-73.9711,3,28,54,-26,0.000844103
1202,40.7763,-73.9643,3,1,5,-4,0.00172125
1204,40.7877,-73.9473,3,18,11,7,0.000555714
1212,40.8699,-73.9208,3,5,16,-11,0.000489591
1213,40.8572,-73.9272,3,6,21,-15,0.000796511
1216,40.8203,-73.9039,3,3,14,-11,0.000599197
1221,40.819,-73.9562,3,5,14,-9,0.000903407
1223,40.8078,-73.9494,3,25,24,1,2.16667e-05
1226,40.8264,-73.9379,3,14,26,-12,0.000916667
1227,40.8109,-73.9634,3,17,4,13,0.000743846
1234,40.7711,-73.9577,3,1,33,-32,0.00116693
1242,40.8351,-73.912,3,8,15,-7,0.000799024
1243,40.7664,-73.9715,3,0,3,-3,0.00360333
1245,40.7995,-73.9556,3,24,28,-4,0.000302917
1247,40.8134,-73.9565,3,22,23,-1,8.51667e-05
1248,40.8766,-73.9094,3,14,18,-4,0.000475
1251,40.786,-73.9151,3,9,9,0,0
1253,40.8068,-73.9607,3,11,3,8,0.00171229
1254,40.7692,-73.967,3,1,16,-15,0.000705333
1256,40.8323,-73.941,3,0,18,-18,0.000802491
1258,40.8605,-73.9057,3,1,14,-13,0.000953154
1264,40.8586,-73.8882,3,13,1,12,0.000925306
1266,40.8693,-73.9152,3,7,3,4,0.000764667
1268,40.784,-73.9472,3,26,13,13,0.000668974
1275,40.8614,-73.9256,3,26,22,4,0.000177667
1277,40.8509,-73.8879,3,4,0,4,0.00033225
1279,40.7677,-73.911,3,12,14,-2,0.00031
1280,40.874,-73.8994,3,4,17,-13,0.00092809
1284,40.8532,-73.9055,3,14,9,5,0.0005457
1297,40.8103,-73.9574,3,4,31,-27,0.000723086
1300,40.8355,-73.9015,3,9,12,-3,0.000128167
1303,40.8559,-73.9271,3,6,7,-1,3.45e-05
1310,40.8185,-73.9476,3,9,6,3,0.000121333
1311,40.837,-73.8904,3,2,2,0,0
1316,40.8305,-73.9399,3,6,22,-16,0.00104168
1325,40.8461,-73.9376,3,0,19,-19,0.000934763
1326,40.8595,-73.9133,3,6,13,-7,0.00045269
1327,40.7645,-73.8717,3,16,20,-4,0.00743663
1328,40.8557,-73.9055,3,17,9,8,0.000511958
1331,40.8807,-73.9008,3,20,10,10,0.0003756
1336,40.88,-73.9054,3,20,9,11,0.000562273
1342,40.8642,-73.8925,3,14,17,-3,0.000155667
1344,40.7628,-73.9343,3,8,18,-10,0.000640517
1345,40.779,-73.9737,3,5,35,-30,0.000631556
1352,40.8407,-73.9151,3,6,16,-10,0.000782483
1355,40.8271,-73.9227,3,0,5,-5,0.00213907
1358,40.8013,-73.9398,3,15,23,-8,0.000631292
1360,40.8206,-73.9176,3,1,14,-13,0.000920744
1361,40.8108,-73.9431,3,16,19,-3,0.000380556
1363,40.8393,-73.9454,3,1,16,-15,0.000872456
1366,40.767,-73.9817,3,2,20,-18,0.00313102
1368,40.773,-73.9112,3,21,23,-2,0.000253417
1369,40.8301,-73.8921,3,15,18,-3,0.000536944
1371,40.8057,-73.9363,3,11,3,8,0.000580229
1373,40.8675,-73.9264,3,10,19,-9,0.000820722
1375,40.8473,-73.9333,3,6,17,-11,0.000666697
1398,40.8518,-73.9164,3,3,14,-11,0.000698939
1400,40.7716,-73.9826,3,1,6,-5,0.002914
1401,40.8362,-73.9398,3,4,22,-18,0.00100355
1408,40.8299,-73.8988,3,6,13,-7,0.0010539
1414,40.8102,-73.9372,3,8,16,-8,0.00100771
1419,40.8478,-73.9019,3,14,18,-4,0.000699167
1420,40.7905,-73.9503,3,16,22,-6,0.000286389
1422,40.8516,-73.8847,3,18,19,-1,0.000195667
1424,40.7616,-73.9726,3,1,3,-2,0.0014825
1425,40.8292,-73.937,3,21,27,-6,0.000744972
1426,40.7932,-73.924,3,3,1,2,0.000588333
1433,40.8766,-73.8837,3,18,14,4,0.000405458
1434,40.8147,-73.9184,3,5,2,3,0.000841278
1435,40.8132,-73.9306,3,10,2,8,0.00106844
1436,40.8111,-73.9149,3,7,20,-13,0.000663526
1438,40.7931,-73.977,3,10,56,-46,0.000786594
1441,40.8317,-73.9021,3,1,16,-15,0.000846333
1442,40.8372,-73.9083,3,1,20,-19,0.00108717
1443,40.8178,-73.9296,3,9,10,-1,2.16667e-05
1450,40.84,-73.9055,3,15,5,10,0.000522317
1451,40.7895,-73.9524,3,9,2,7,0.00129167
1457,40.8525,-73.9344,3,3,18,-15,0.000863378
1458,40.813,-73.9419,3,11,16,-5,0.000477667
1461,40.8056,-73.9341,3,8,5,3,0.000359333
1462,40.8162,-73.9482,3,9,18,-9,0.000661481
1463,40.7934,-73.9495,3,14,16,-2,4.41667e-05
1464,40.8085,-73.9288,3,10,12,-2,0.000163917
1465,40.8273,-73.8964,3,15,15,0,0
1467,40.7688,-73.9614,3,2,40,-38,0.000787456
1470,40.8739,-73.8953,3,5,1,4,0.000713583
1475,40.764,-73.9646,3,4,53,-49,0.00104949
1476,40.8645,-73.8952,3,2,15,-13,0.000630551
1478,40.8328,-73.9294,3,2,12,-10,0.0003802
1487,40.822,-73.8968,3,21,8,13,0.000539321
1491,40.8421,-73.9422,3,3,3,0,0
1494,40.8309,-73.9112,3,26,25,1,1.88333e-05
1497,40.8467,-73.8899,3,2,13,-11,0.000394697
1500,40.8473,-73.8998,3,23,18,5,0.000912267
1502,40.8253,-73.9362,3,7,4,3,0.000191333
1507,40.8863,-73.8997,3,32,4,28,0.00067572
1508,40.7881,-73.9521,3,2,4,-2,0.000516667
1510,40.8197,-73.9013,3,1,6,-5,0.0008283
1519,40.8716,-73.8971,3,3,2,1,0.000418333
1526,40.8594,-73.8985,3,1,4,-3,0.00147478
1528,40.8183,-73.9604,3,21,9,12,0.000608194
1529,40.778,-73.9541,3,2,12,-10,0.00149417
1530,40.8114,-73.9519,3,19,10,9,0.000627222
1531,40.8811,-73.8965,3,4,18,-14,0.00102
1534,40.8314,-73.9262,3,18,13,5,0.000872233
1537,40.8121,-73.9613,3,2,29,-27,0.00113111
1539,40.817,-73.9423,3,14,18,-4,0.000621667
1544,40.7862,-73.9756,3,27,56,-29,0.000531782
1545,40.8387,-73.927,3,16,15,1,9.78333e-05
1546,40.8151,-73.8999,3,14,14,0,0
1548,40.827,-73.9075,3,3,2,1,0.000454667
1549,40.8517,-73.909,3,14,8,6,0.000333611
1550,40.8483,-73.9413,3,1,23,-22,0.000777447
1557,40.82,-73.9214,3,8,11,-3,0.000365667
1559,40.8192,-73.9411,3,13,18,-5,0.000603667
1563,40.7991,-73.9389,3,23,24,-1,0.000243333
1565,40.7639,-73.9365,3,7,13,-6,0.00105044
1566,40.7659,-73.9763,3,1,5,-4,0.00170917
1574,40.8159,-73.9119,3,4,7,-3,0.000212222
1576,40.7767,-73.9276,3,13,28,-15,0.00129744
1579,40.8272,-73.9427,3,2,21,-19,0.00103473
1580,40.7632,-73.9399,3,6,12,-6,0.000486944
1581,40.7829,-73.9787,3,14,43,-29,0.000530747
1588,40.8273,-73.952,3,7,31,-24,0.000661174
1589,40.8744,-73.8919,3,16,3,13,0.000658692
1592,40.8263,-73.8988,3,8,16,-8,0.000863875
1603,40.8172,-73.9147,3,4,3,1,5.91667e-05
1608,40.8295,-73.9443,3,3,14,-11,0.000566061
1611,40.7666,-73.9287,3,4,15,-11,0.00104697
1614,40.8281,-73.9129,3,12,16,-4,0.000689875
1617,40.8632,-73.9208,3,13,11,2,0.000183
1623,40.843,-73.9117,3,0,2,-2,0.002922
1624,40.8755,-73.9021,3,12,12,0,0
1630,40.8731,-73.8897,3,15,5,10,0.000405167
1632,40.7678,-73.9659,3,2,13,-11,0.000757727
1648,40.8164,-73.9195,3,7,3,4,0.000534167
1658,40.8583,-73.9101,3,0,3,-3,0.000704278
1659,40.7752,-73.9892,3,21,36,-15,0.000567333
1661,40.8248,-73.9164,3,11,17,-6,0.000830333
1662,40.7714,-73.9077,3,5,17,-12,0.000899708
1664,40.7923,-73.9383,3,12,22,-10,0.00112233
1665,40.8349,-73.9037,3,10,18,-8,0.000982917
1666,40.8496,-73.9192,3,1,15,-14,0.000573548
1669,40.8783,-73.9051,3,15,4,11,0.000472652
1676,40.7666,-73.9535,3,11,12,-1,0.0001
1678,40.8333,-73.9393,3,2,20,-18,0.00113773
1679,40.8235,-73.9439,3,6,19,-13,0.000489987
1689,40.8511,-73.9288,3,7,21,-14,0.00480029
1690,40.8798,-73.9016,3,15,12,3,0.000145333
1692,40.8488,-73.9032,3,4,14,-10,0.0004775
1695,40.8144,-73.9532,3,5,13,-8,0.00049
1699,40.8478,-73.883,3,13,22,-9,0.000763574
1706,40.7633,-73.9088,3,2,11,-9,0.000838148
1719,40.7658,-73.9068,3,3,19,-16,0.000686833
1722,40.7988,-73.9523,3,32,22,10,0.0009555
1726,40.8187,-73.8902,3,8,27,-19,0.000686307
1727,40.7762,-73.9105,3,2,5,-3,0.00181222
1733,40.8405,-73.9192,3,15,1,14,0.000897048
1736,40.7903,-73.9476,3,14,30,-16,0.0008825
1738,40.7956,-73.9619,3,25,33,-8,0.000867292
1739,40.8166,-73.928,3,12,2,10,0.000874333
1740,40.8819,-73.9029,3,27,5,22,0.000591167
1741,40.8239,-73.894,3,6,14,-8,0.000422708
1742,40.8198,-73.9365,3,8,9,-1,8.33333e-06
1743,40.8012,-73.9501,3,20,24,-4,0.000390833
1744,40.8448,-73.912,3,7,20,-13,0.000645769
1746,40.8585,-73.8964,3,4,11,-7,0.000898714
1748,40.8161,-73.8916,3,17,2,15,0.000775444
1751,40.8687,-73.8966,3,13,8,5,0.000156067
1752,40.8219,-73.9075,3,8,12,-4,0.00156962
1756,40.7692,-73.901,3,8,13,-5,0.000635767
1766,40.7752,-73.9445,3,18,20,-2,0.0003575
1768,40.7749,-73.9827,3,2,8,-6,0.00226528
1769,40.8546,-73.8951,3,20,18,2,0.000104083
1770,40.8705,-73.9029,3,7,19,-12,0.000862889
1772,40.8218,-73.9535,3,2,18,-16,0.000966917
1777,40.806,-73.9649,3,3,7,-4,0.00134875
1779,40.8849,-73.8908,3,2,22,-20,0.00101904
1780,40.792,-73.946,3,25,24,1,0.000676667
1781,40.8362,-73.9073,3,6,19,-13,0.000670628
1784,40.8005,-73.942,3,14,24,-10,0.00106942
1785,40.7712,-73.9039,3,11,18,-7,0.000274048
1791,40.7989,-73.9448,3,23,27,-4,0.000679542
1792,40.8721,-73.8846,3,14,17,-3,0.0006925
1798,40.8626,-73.9201,3,13,2,11,0.000766333
1799,40.8042,-73.967,3,21,18,3,0.000645556
1801,40.8688,-73.9315,3,15,8,7,0.000332571
1802,40.7728,-73.9669,3,0,2,-2,0.00188083
1807,40.8565,-73.933,3,16,18,-2,0.000547417
1808,40.8135,-73.9452,3,12,18,-6,0.000521389
1809,40.7703,-73.8937,3,13,17,-4,0.000674375
1811,40.841,-73.8792,3,19,4,15,0.00108624
1824,40.8517,-73.9419,3,11,17,-6,0.000658917
1830,40.7643,-73.8916,3,8,17,-9,0.00140052
1831,40.7693,-73.9846,3,5,16,-11,0.000595
1837,40.7748,-73.9038,3,8,16,-8,0.000643958
1840,40.787,-73.9416,3,14,15,-1,0.000115
1841,40.8017,-73.9095,3,8,0,8,0.00153975
1842,40.8101,-73.9397,3,13,13,0,0
1845,40.8707,-73.9068,3,16,9,7,0.000295381
1846,40.8244,-73.9282,3,25,4,21,0.000789889
1849,40.8629,-73.9074,3,1,21,-20,0.000953783
1852,40.844,-73.9337,3,5,16,-11,0.000670106
1857,40.7757,-73.9564,3,12,27,-15,0.000759889
1862,40.819,-73.9448,3,3,17,-14,0.00108833
1874,40.8307,-73.9364,3,17,17,0,0
1879,40.7902,-73.9729,3,5,26,-21,0.000995317
1881,40.7886,-73.9436,3,18,25,-7,0.000292143
1882,40.7717,-73.9316,3,8,27,-19,0.000858921
1887,40.7863,-73.9455,3,18,26,-8,0.000734667
1895,40.8794,-73.8853,3,13,4,9,0.001145
1897,40.852,-73.8944,3,10,9,1,4.15e-05
1901,40.8248,-73.9024,3,2,12,-10,0.000715867
1902,40.7746,-73.9185,3,9,16,-7,0.00117881
1904,40.8429,-73.9386,3,3,24,-21,0.000864905
1907,40.8267,-73.9293,3,13,4,9,0.000643537
1908,40.7884,-73.9747,3,18,38,-20,0.0010615
1910,40.7675,-73.9209,3,2,6,-4,0.0015575
1919,40.7687,-73.925,3,7,17,-10,0.00139733
1922,40.85,-73.9384,3,9,22,-13,0.00103462
1924,40.8096,-73.9179,3,15,10,5,0.000459667
1925,40.8476,-73.9074,3,5,18,-13,0.000827782
1927,40.7942,-73.9741,3,22,21,1,0.000115
1931,40.8569,-73.9357,3,2,15,-13,0.00110995
1932,40.8211,-73.8951,3,18,4,14,0.000907048
1935,40.7591,-73.9627,3,31,32,-1,2.5e-05
1939,40.8422,-73.9351,3,7,19,-12,0.000724361
1940,40.8182,-73.8941,3,8,12,-4,0.000273583
1949,40.8228,-73.9513,3,4,16,-12,0.00106828
1951,40.853,-73.9183,3,6,9,-3,0.000106111
1952,40.8283,-73.9429,3,1,16,-15,0.00140326
1954,40.8222,-73.9147,3,18,21,-3,0.000730333
1955,40.8608,-73.9025,3,8,11,-3,0.000195667
1957,40.8057,-73.9252,3,9,15,-6,0.000662556
1958,40.8182,-73.951,3,10,19,-9,0.000336296
1960,40.7613,-73.9096,3,7,15,-8,0.000605417
1961,40.8535,-73.8818,3,7,10,-3,0.000234111
1962,40.7825,-73.9489,3,56,59,-3,0.000172778
1965,40.7668,-73.9348,3,13,24,-11,0.000533788
1966,40.8617,-73.9186,3,21,4,17,0.000494696
1976,40.8474,-73.9114,3,14,13,1,5.93333e-05
1979,40.8367,-73.9261,3,9,18,-9,0.000879389
1987,40.8289,-73.9052,3,2,10,-8,0.000403
1989,40.8832,-73.9059,3,17,17,0,0
1992,40.761,-73.9672,3,9,11,-2,0.00031
1995,40.7938,-73.9719,3,4,9,-5,0.000898333
1998,40.7646,-73.9735,3,0,12,-12,0.00174306
2001,40.7812,-73.9496,3,68,57,11,0.000614091
2003,40.8353,-73.8951,3,2,15,-13,0.000954462
2005,40.8341,-73.9483,3,17,21,-4,0.001261
2008,40.7787,-73.9146,3,6,16,-10,0.00123043
2022,40.7739,-73.9544,3,13,30,-17,0.000675588
2024,40.7684,-73.8935,3,9,16,-7,0.000659905
2040,40.8109,-73.9216,3,12,14,-2,0.000660083
2041,40.7768,-73.959,3,14,43,-29,0.000801437
2044,40.8209,-73.9392,3,15,17,-2,0.00020425
2046,40.85,-73.9059,3,2,15,-13,0.00102058
2048,40.8601,-73.8866,3,23,2,21,0.001035
2049,40.7852,-73.9767,3,10,34,-24,0.00100639
2050,40.8026,-73.9491,3,10,6,4,0.000621667
2052,40.8646,-73.9186,3,30,5,25,0.00103667
2061,40.84,-73.9429,3,0,3,-3,0.00196294
2062,40.7715,-73.9905,3,16,17,-1,0.000291667
2064,40.7979,-73.9423,3,10,17,-7,0.000579524
2065,40.7783,-73.9488,3,25,35,-10,0.00103283
2067,40.7956,-73.9191,3,17,1,16,0.000921021
2071,40.8411,-73.8923,3,6,10,-4,0.000349
2074,40.8669,-73.9019,3,0,18,-18,0.000921806
2079,40.8589,-73.9231,3,3,13,-10,0.00040675
2080,40.8064,-73.9361,3,17,6,11,0.000785894
2088,40.847,-73.8866,3,3,16,-13,0.000879577
2089,40.8017,-73.9571,3,28,27,1,2e-05
2090,40.7805,-73.9122,3,12,17,-5,0.000974
2092,40.7969,-73.9373,3,17,24,-7,0.000646976
2094,40.8665,-73.8904,3,8,15,-7,0.000831524
2096,40.8485,-73.9361,3,1,23,-22,0.000954833
2097,40.7601,-73.9071,3,10,22,-12,0.00119858
2101,40.8026,-73.9335,3,11,5,6,0.000999278
2105,40.7771,-73.979,3,2,59,-57,0.00121368
2106,40.8042,-73.9115,3,12,8,4,0.000439208
2108,40.8173,-73.923,3,22,11,11,0.000869091
